Player,Position,Age,Games,GS,MP,FG,FGA,FG_PCT,FG3,FG3A,FG3_PCT,FG2,FG2A,FG2_PCT,EFG_PCT,FT,FTA,FT_PCT,ORB,DRB,TRB,AST,STL,BLK,TOV,PF,PTS
Precious Achiuwa,PF,21,42,2,541,93,162,.574,0,0,,93,162,.574,.574,47,91,.516,53,101,154,21,15,20,34,63,233
Jaylen Adams,PG,24,7,0,18,1,8,.125,0,2,.000,1,6,.167,.125,0,0,,0,3,3,2,0,0,0,1,2
Steven Adams,C,27,40,40,1108,140,222,.631,0,2,.000,140,220,.636,.631,43,93,.462,161,205,366,80,35,23,62,80,323
Bam Adebayo,C,23,38,38,1279,270,485,.557,2,7,.286,268,478,.561,.559,186,220,.845,89,271,360,204,33,41,108,90,728
LaMarcus Aldridge,C,35,21,18,544,115,248,.464,27,75,.360,88,173,.509,.518,31,37,.838,17,77,94,36,8,18,20,36,288
Ty-Shon Alexander,SG,22,4,0,10,0,4,.000,0,2,.000,0,2,.000,.000,0,0,,0,1,1,1,0,0,0,1,0
Nickeil Alexander-Walker,SG,22,35,5,657,121,289,.419,46,142,.324,75,147,.510,.498,33,41,.805,9,88,97,66,34,14,45,60,321
Grayson Allen,SG,25,29,17,715,93,223,.417,59,146,.404,34,77,.442,.549,42,47,.894,12,81,93,62,29,5,29,37,287
Jarrett Allen,C,22,43,25,1226,205,320,.641,4,10,.400,201,310,.648,.647,148,208,.712,130,295,425,69,19,73,65,68,562
Al-Farouq Aminu,PF,30,17,14,367,36,89,.404,7,31,.226,29,58,.500,.444,14,17,.824,20,71,91,29,17,9,25,22,93
Kyle Anderson,PF,27,39,39,1061,182,381,.478,53,146,.363,129,235,.549,.547,75,98,.765,31,195,226,129,44,26,54,66,492
Giannis Antetokounmpo,PF,26,41,41,1400,426,762,.559,47,157,.299,379,605,.626,.590,275,406,.677,73,403,476,263,50,53,152,121,1174
Kostas Antetokounmpo,PF,23,5,0,24,2,4,.500,0,0,,2,4,.500,.500,2,4,.500,2,7,9,0,2,3,6,3,6
Thanasis Antetokounmpo,SF,28,31,0,261,30,51,.588,2,9,.222,28,42,.667,.608,7,16,.438,29,32,61,20,9,6,19,36,69
Carmelo Anthony,PF,36,42,3,1080,208,497,.419,75,194,.387,133,303,.439,.494,97,113,.858,23,115,138,71,35,31,43,96,588
Cole Anthony,PG,20,25,17,667,101,269,.375,27,83,.325,74,186,.398,.426,46,55,.836,20,91,111,94,17,11,51,51,275
OG Anunoby,SF,23,26,26,863,135,277,.487,59,144,.410,76,133,.571,.594,43,57,.754,36,113,149,44,45,20,43,74,372
Ryan Arcidiacono,PG,26,26,0,296,30,78,.385,15,47,.319,15,31,.484,.481,11,14,.786,3,39,42,33,7,0,6,30,86
Trevor Ariza,F,35,3,0,49,4,17,.235,2,10,.200,2,7,.286,.294,2,2,1.000,0,10,10,3,1,2,1,3,12
D.J. Augustin,PG,33,40,6,775,76,210,.362,51,140,.364,25,70,.357,.483,40,44,.909,13,44,57,123,23,1,38,36,243
Deni Avdija,SF,20,38,17,836,92,207,.444,38,115,.330,54,92,.587,.536,15,24,.625,15,157,172,46,22,8,28,102,237
Deandre Ayton,C,22,43,43,1312,271,446,.608,4,17,.235,267,429,.622,.612,86,113,.761,141,329,470,66,16,48,72,135,632
Udoka Azubuike,C,21,12,0,49,4,7,.571,0,0,,4,7,.571,.571,4,6,.667,4,9,13,0,1,4,3,8,12
Dwayne Bacon,SG,25,44,26,1095,159,398,.399,44,132,.333,115,266,.432,.455,74,87,.851,12,113,125,49,23,3,30,71,436
Marvin Bagley III,PF,21,37,37,951,209,416,.502,34,96,.354,175,320,.547,.543,61,109,.560,91,184,275,35,18,19,49,90,513
LaMelo Ball,PG,19,41,21,1174,237,526,.451,81,216,.375,156,310,.503,.528,97,123,.789,54,186,240,251,65,14,115,116,652
Lonzo Ball,PG,23,38,38,1205,196,461,.425,114,296,.385,82,165,.497,.549,33,43,.767,22,136,158,211,50,21,76,77,539
Mo Bamba,C,22,22,0,224,42,88,.477,9,32,.281,33,56,.589,.528,8,14,.571,23,63,86,6,3,20,9,31,101
Desmond Bane,SG,22,37,10,832,131,270,.485,65,143,.455,66,127,.520,.606,25,29,.862,15,91,106,49,26,5,37,71,352
Harrison Barnes,PF,28,41,41,1476,223,453,.492,62,171,.363,161,282,.571,.561,151,182,.830,46,223,269,150,29,7,60,54,659
RJ Barrett,SG,20,44,44,1488,291,643,.453,50,145,.345,241,498,.484,.491,131,179,.732,50,217,267,132,30,11,84,113,763
Will Barton,SF,30,41,37,1261,197,453,.435,72,191,.377,125,262,.477,.514,53,71,.746,28,140,168,127,36,18,68,68,519
Keita Bates-Diop,SF,25,16,0,118,11,32,.344,5,15,.333,6,17,.353,.422,7,10,.700,5,15,20,7,6,1,1,5,34
Nicolas Batum,SF,32,42,37,1199,125,265,.472,78,179,.436,47,86,.547,.619,39,46,.848,34,161,195,98,48,15,31,71,367
Aron Baynes,C,34,41,29,766,101,238,.424,20,80,.250,81,158,.513,.466,23,32,.719,70,149,219,37,12,16,36,93,245
Kent Bazemore,SF,31,42,1,690,90,204,.441,41,103,.398,49,101,.485,.542,30,44,.682,15,105,120,64,33,22,47,91,251
Darius Bazley,PF,20,36,36,1104,158,403,.392,54,186,.290,104,217,.479,.459,57,81,.704,22,248,270,54,18,23,63,31,427
Bradley Beal,SG,27,39,39,1394,435,892,.488,85,255,.333,350,637,.549,.535,286,317,.902,44,155,199,181,49,15,129,96,1241
Malik Beasley,SG,24,33,32,1093,250,550,.455,116,286,.406,134,264,.508,.560,61,72,.847,27,126,153,81,27,6,54,54,677
Jordan Bell,C,26,3,1,50,5,15,.333,0,2,.000,5,13,.385,.333,0,0,,5,11,16,5,1,3,3,4,10
DeAndre' Bembry,SF,26,32,7,548,63,118,.534,9,28,.321,54,90,.600,.572,17,25,.680,17,60,77,62,21,10,33,50,152
Dāvis Bertāns,PF,28,35,3,864,112,288,.389,97,254,.382,15,34,.441,.557,58,68,.853,15,86,101,30,21,8,21,86,379
Patrick Beverley,PG,32,29,29,689,80,181,.442,50,119,.420,30,62,.484,.580,31,39,.795,27,80,107,60,25,23,27,91,241
Saddiq Bey,SF,21,41,24,999,140,344,.407,92,238,.387,48,106,.453,.541,65,74,.878,23,145,168,50,26,4,29,66,437
Tyler Bey,SF,22,7,0,23,3,9,.333,0,1,.000,3,8,.375,.333,2,4,.500,2,4,6,1,0,1,0,3,8
Khem Birch,C,28,43,1,849,83,176,.472,4,18,.222,79,158,.500,.483,61,83,.735,107,112,219,43,25,26,21,60,231
Goga Bitadze,C,21,24,0,230,37,79,.468,5,27,.185,32,52,.615,.500,17,24,.708,22,34,56,6,5,24,9,37,96
Bismack Biyombo,C,28,41,22,890,96,166,.578,0,1,.000,96,165,.582,.578,35,72,.486,87,132,219,55,11,47,41,98,227
Nemanja Bjelica,PF,32,26,1,439,69,150,.460,17,58,.293,52,92,.565,.517,32,42,.762,24,76,100,49,8,2,28,48,187
Eric Bledsoe,SG,31,42,41,1225,172,413,.416,72,198,.364,100,215,.465,.504,59,90,.656,17,125,142,157,30,13,65,71,475
Keljin Blevins,SF,25,9,0,47,2,11,.182,0,4,.000,2,7,.286,.182,0,0,,0,2,2,4,2,0,3,4,4
Bogdan Bogdanović,SG,28,19,2,445,70,173,.405,39,113,.345,31,60,.517,.517,14,15,.933,7,57,64,42,10,4,19,38,193
Bojan Bogdanović,SF,31,43,43,1299,208,502,.414,107,279,.384,101,223,.453,.521,121,139,.871,22,143,165,82,22,2,65,70,644
Bol Bol,PF,21,19,2,102,16,33,.485,7,16,.438,9,17,.529,.591,4,7,.571,0,15,15,6,2,6,9,10,43
Marques Bolden,C,22,6,0,29,1,3,.333,0,0,,1,3,.333,.333,5,8,.625,3,3,6,0,2,2,2,0,7
Jordan Bone,PG,23,14,0,196,23,54,.426,10,32,.313,13,22,.591,.519,0,0,,4,20,24,18,2,0,3,11,56
Isaac Bonga,SF,21,27,7,333,23,59,.390,11,35,.314,12,24,.500,.483,3,4,.750,16,40,56,16,7,7,14,45,60
Devin Booker,SG,24,39,39,1316,364,735,.495,78,223,.350,286,512,.559,.548,173,206,.840,13,145,158,182,34,10,129,111,979
Chris Boucher,C,28,44,3,1041,213,401,.531,68,162,.420,145,239,.607,.616,108,142,.761,82,199,281,43,23,84,31,121,602
Brian Bowen,SF,22,2,0,7,1,2,.500,0,0,,1,2,.500,.500,1,1,1.000,0,1,1,0,0,0,0,0,3
Avery Bradley,SG,30,10,1,211,31,66,.470,16,38,.421,15,28,.536,.591,7,9,.778,2,16,18,14,7,1,9,26,85
Tony Bradley,C,23,20,8,287,51,75,.680,0,1,.000,51,74,.689,.680,7,11,.636,39,65,104,17,6,13,6,28,109
Jarrell Brantley,PF,24,13,0,35,6,13,.462,4,9,.444,2,4,.500,.615,0,0,,2,5,7,2,2,1,1,5,16
Ignas Brazdeikis,SF,22,4,0,7,0,1,.000,0,0,,0,1,.000,.000,2,2,1.000,1,1,2,1,0,0,1,0,2
Mikal Bridges,SF,24,43,43,1395,212,404,.525,79,191,.414,133,213,.624,.623,76,91,.835,50,156,206,102,34,39,36,67,579
Miles Bridges,PF,22,43,2,1130,155,312,.497,52,139,.374,103,173,.595,.580,47,52,.904,53,190,243,87,28,30,67,96,409
Malcolm Brogdon,PG,28,41,41,1457,336,729,.461,106,266,.398,230,463,.497,.534,100,114,.877,33,159,192,247,44,10,93,81,878
Dillon Brooks,SF,25,38,38,1110,228,577,.395,69,216,.319,159,361,.440,.455,84,98,.857,33,81,114,97,50,16,76,131,609
Bruce Brown,PG,24,41,25,861,142,258,.550,9,37,.243,133,221,.602,.568,47,66,.712,65,121,186,59,30,12,31,85,340
Jaylen Brown,SG,24,41,41,1402,383,784,.489,105,267,.393,278,517,.538,.555,141,187,.754,45,188,233,159,50,22,114,118,1012
Moses Brown,C,21,15,4,248,44,74,.595,0,0,,44,74,.595,.595,24,41,.585,38,65,103,4,8,19,10,30,112
Sterling Brown,SG,25,41,9,984,111,262,.424,66,171,.386,45,91,.495,.550,20,22,.909,31,151,182,64,35,10,32,81,308
Troy Brown Jr.,SF,21,21,0,287,33,89,.371,14,46,.304,19,43,.442,.449,10,15,.667,11,50,61,19,3,4,16,29,90
Jalen Brunson,PG,24,38,8,932,172,324,.531,47,118,.398,125,206,.607,.603,78,95,.821,12,123,135,124,20,0,51,60,469
Thomas Bryant,C,23,10,10,271,59,91,.648,9,21,.429,50,70,.714,.698,16,24,.667,18,43,61,15,4,8,11,31,143
Reggie Bullock,SF,29,39,38,1083,129,309,.417,80,203,.394,49,106,.462,.547,24,28,.857,11,121,132,53,29,8,29,89,362
Trey Burke,PG,28,41,0,617,103,229,.450,45,117,.385,58,112,.518,.548,27,31,.871,4,33,37,60,24,2,21,46,278
Alec Burks,SG,29,32,4,823,137,329,.416,61,151,.404,76,178,.427,.509,67,78,.859,17,122,139,70,26,8,34,63,402
Jimmy Butler,SF,31,30,30,1002,212,441,.481,11,52,.212,201,389,.517,.493,205,240,.854,65,172,237,218,60,11,70,40,640
Bruno Caboclo,PF,25,6,0,36,8,17,.471,0,5,.000,8,12,.667,.471,1,2,.500,3,11,14,1,0,2,4,6,17
Devontae Cacok,PF,24,8,1,44,9,13,.692,0,0,,9,13,.692,.692,0,2,.000,4,8,12,1,4,1,2,3,18
Kentavious Caldwell-Pope,SG,27,40,40,1040,113,268,.422,59,147,.401,54,121,.446,.532,47,55,.855,17,78,95,58,30,11,39,62,332
Facundo Campazzo,PG,29,38,1,674,59,158,.373,38,110,.345,21,48,.438,.494,33,41,.805,8,42,50,106,39,8,33,75,189
Vlatko Čančar,PF,23,24,0,143,13,32,.406,4,17,.235,9,15,.600,.469,5,6,.833,5,23,28,8,8,2,9,12,35
Clint Capela,C,26,38,38,1112,243,416,.584,0,0,,243,416,.584,.584,69,125,.552,193,348,541,35,27,83,51,87,555
Vernon Carey Jr.,C,19,7,0,25,2,4,.500,0,1,.000,2,3,.667,.500,1,2,.500,2,7,9,1,0,1,1,0,5
Jevon Carter,PG,25,34,0,322,36,95,.379,21,64,.328,15,31,.484,.489,2,2,1.000,3,36,39,38,13,7,6,33,95
Wendell Carter Jr.,C,21,32,25,792,129,252,.512,8,22,.364,121,230,.526,.528,82,111,.739,70,180,250,69,18,24,49,96,348
Michael Carter-Williams,SG,29,23,18,612,80,200,.400,11,45,.244,69,155,.445,.428,35,49,.714,33,72,105,97,13,11,53,68,206
Alex Caruso,PG,26,34,0,677,70,166,.422,31,76,.408,39,90,.433,.515,26,39,.667,21,78,99,82,35,7,36,60,197
Willie Cauley-Stein,C,27,35,11,599,79,127,.622,1,8,.125,78,119,.655,.626,33,50,.660,40,110,150,26,11,28,16,80,192
Chris Chiozza,PG,25,16,0,165,21,63,.333,11,32,.344,10,31,.323,.421,10,13,.769,3,13,16,47,6,4,11,11,63
Marquese Chriss,PF,23,2,0,27,5,14,.357,1,5,.200,4,9,.444,.393,2,4,.500,3,10,13,2,0,2,2,3,13
Gary Clark,SF,26,35,11,637,40,131,.305,31,108,.287,9,23,.391,.424,8,10,.800,33,79,112,30,12,7,17,34,119
Brandon Clarke,PF,24,36,16,940,176,338,.521,17,54,.315,159,284,.560,.546,52,75,.693,56,147,203,56,39,32,21,55,421
Jordan Clarkson,SG,28,43,0,1104,270,636,.425,131,369,.355,139,267,.521,.528,68,71,.958,37,130,167,94,38,7,76,61,739
Nicolas Claxton,C,21,13,0,244,52,82,.634,1,4,.250,51,78,.654,.640,17,29,.586,12,43,55,11,10,19,8,24,122
Amir Coffey,SG,23,27,0,200,28,57,.491,15,33,.455,13,24,.542,.623,9,17,.529,6,12,18,12,5,0,9,12,80
John Collins,PF,23,44,44,1347,312,577,.541,55,148,.372,257,429,.599,.588,118,141,.837,97,247,344,58,23,49,56,144,797
Mike Conley,PG,33,35,35,1034,199,436,.456,97,229,.424,102,207,.493,.568,79,95,.832,29,92,121,189,48,5,68,66,574
Pat Connaughton,SG,28,40,1,895,99,214,.463,60,146,.411,39,68,.574,.603,16,21,.762,38,143,181,55,28,16,17,64,274
Quinn Cook,PG,27,22,0,143,26,60,.433,10,23,.435,16,37,.432,.517,5,6,.833,2,14,16,17,4,1,5,10,67
Tyler Cook,PF,23,7,0,43,4,8,.500,0,0,,4,8,.500,.500,1,2,.500,4,7,11,2,0,0,2,4,9
DeMarcus Cousins,C,30,25,11,506,79,210,.376,39,116,.336,40,94,.426,.469,44,59,.746,30,161,191,60,21,18,39,74,241
Robert Covington,PF,30,41,41,1324,123,309,.398,81,218,.372,42,91,.462,.529,25,31,.806,31,243,274,70,67,49,48,112,352
Torrey Craig,SF,30,21,0,248,27,61,.443,12,27,.444,15,34,.441,.541,1,2,.500,18,37,55,19,10,8,6,31,67
Jae Crowder,PF,30,40,25,1107,139,338,.411,98,251,.390,41,87,.471,.556,35,43,.814,18,180,198,80,34,12,34,73,411
Jarrett Culver,SG,21,22,7,402,56,135,.415,8,37,.216,48,98,.490,.444,23,39,.590,30,61,91,17,13,7,24,45,143
Seth Curry,SG,30,33,33,976,152,329,.462,67,155,.432,85,174,.489,.564,56,61,.918,6,67,73,96,30,8,48,56,427
Stephen Curry,PG,32,39,39,1316,375,789,.475,182,446,.408,193,343,.563,.591,198,213,.930,18,190,208,243,53,3,120,72,1130
Nate Darling,SG,22,2,0,7,1,4,.250,1,4,.250,0,0,,.375,0,0,,0,0,0,1,0,0,0,0,3
Anthony Davis,PF,27,23,23,755,204,383,.533,17,58,.293,187,325,.575,.555,93,130,.715,47,146,193,70,31,41,45,42,518
Ed Davis,C,31,19,7,264,18,43,.419,0,0,,18,43,.419,.419,7,8,.875,38,59,97,19,10,10,6,49,43
Terence Davis,SG,23,34,4,493,87,210,.414,44,122,.361,43,88,.489,.519,16,18,.889,9,57,66,37,17,7,29,48,234
DeMar DeRozan,PF,31,34,34,1156,239,484,.494,18,58,.310,221,426,.519,.512,202,229,.882,22,129,151,248,32,10,58,67,698
Mamadi Diakite,PF,24,2,0,9,1,2,.500,0,0,,1,2,.500,.500,0,0,,0,3,3,2,0,2,0,3,2
Hamidou Diallo,SG,22,32,5,761,143,297,.481,12,41,.293,131,256,.512,.502,83,132,.629,37,128,165,77,31,12,49,83,381
Gorgui Dieng,C,31,22,1,371,56,108,.519,23,48,.479,33,60,.550,.625,38,43,.884,28,70,98,29,17,14,22,38,173
Spencer Dinwiddie,SG,27,3,3,64,6,16,.375,2,7,.286,4,9,.444,.438,6,6,1.000,0,13,13,9,2,1,5,4,20
Donte DiVincenzo,SG,24,43,43,1171,172,403,.427,84,217,.387,88,186,.473,.531,31,46,.674,54,181,235,131,48,9,58,64,459
Luka Dončić,PG,21,39,39,1373,394,817,.482,114,311,.367,280,506,.553,.552,214,286,.748,31,291,322,353,39,25,166,82,1116
Luguentz Dort,SG,21,40,40,1187,173,449,.385,78,240,.325,95,209,.455,.472,81,106,.764,27,112,139,64,35,14,57,98,505
Damyean Dotson,SG,26,32,6,602,80,208,.385,30,110,.273,50,98,.510,.457,20,28,.714,4,56,60,69,13,4,25,30,210
Devon Dotson,PG,21,1,0,10,2,4,.500,0,0,,2,4,.500,.500,0,0,,0,1,1,0,0,0,0,1,4
Sekou Doumbouya,PF,20,38,2,493,53,155,.342,17,69,.246,36,86,.419,.397,21,28,.750,17,65,82,23,14,2,25,55,144
PJ Dozier,SG,24,29,0,588,82,183,.448,29,77,.377,53,106,.500,.527,29,46,.630,23,85,108,46,15,15,25,52,222
Goran Dragić,PG,34,28,8,757,139,315,.441,45,129,.349,94,186,.505,.513,65,77,.844,9,83,92,136,17,6,75,65,388
Andre Drummond,C,27,25,25,722,180,380,.474,0,8,.000,180,372,.484,.474,77,129,.597,101,236,337,64,40,29,81,69,437
Jared Dudley,PF,35,11,0,76,2,7,.286,2,5,.400,0,2,.000,.429,0,0,,4,15,19,5,1,1,2,7,6
Kevin Durant,PF,32,19,18,679,188,359,.524,49,113,.434,139,246,.565,.592,126,145,.869,7,132,139,100,14,27,67,43,551
Anthony Edwards,SG,19,44,27,1334,274,710,.386,94,298,.315,180,412,.437,.452,103,133,.774,34,154,188,113,42,16,88,74,745
Carsen Edwards,SG,22,16,1,163,32,69,.464,11,36,.306,21,33,.636,.543,7,9,.778,2,16,18,9,5,1,2,19,82
CJ Elleby,SF,20,14,0,117,14,34,.412,5,21,.238,9,13,.692,.485,6,9,.667,5,10,15,3,4,3,3,18,39
Henry Ellenson,PF,24,2,0,38,5,14,.357,2,9,.222,3,5,.600,.429,3,4,.750,3,9,12,5,0,0,0,7,15
Wayne Ellington,SG,33,31,25,720,114,249,.458,85,197,.431,29,52,.558,.629,20,27,.741,8,48,56,45,13,6,23,46,333
Joel Embiid,C,26,31,31,1010,293,558,.525,38,90,.422,255,468,.545,.559,304,354,.859,67,288,355,101,37,43,99,77,928
James Ennis,SF,30,27,23,582,67,136,.493,26,60,.433,41,76,.539,.588,40,51,.784,30,78,108,36,22,6,24,56,200
Drew Eubanks,C,23,24,0,317,42,88,.477,1,1,1.000,41,87,.471,.483,24,34,.706,16,65,81,21,4,27,19,31,109
Dante Exum,SG,25,6,3,116,10,26,.385,2,11,.182,8,15,.533,.423,1,2,.500,2,15,17,13,4,2,7,9,23
Tacko Fall,C,25,10,0,68,13,18,.722,0,0,,13,18,.722,.722,3,11,.273,8,16,24,2,0,10,2,12,29
Derrick Favors,C,29,41,0,653,98,151,.649,0,1,.000,98,150,.653,.649,47,62,.758,85,137,222,35,23,38,23,96,243
Cristiano Felício,C,28,7,0,40,3,4,.750,0,0,,3,4,.750,.750,5,8,.625,6,6,12,5,2,0,3,3,11
Terrance Ferguson,SG,22,13,0,49,1,7,.143,0,5,.000,1,2,.500,.143,0,0,,0,1,1,2,1,0,4,7,2
Bruno Fernando,C,22,21,0,163,11,27,.407,0,2,.000,11,25,.440,.407,9,15,.600,13,50,63,9,2,3,15,18,31
Yogi Ferrell,PG,27,2,0,40,8,21,.381,3,9,.333,5,12,.417,.452,0,2,.000,3,4,7,5,3,1,3,4,19
Dorian Finney-Smith,PF,27,31,31,965,95,223,.426,52,148,.351,43,75,.573,.543,19,21,.905,46,117,163,45,28,12,19,80,261
Malachi Flynn,PG,22,19,0,175,15,58,.259,6,33,.182,9,25,.360,.310,4,6,.667,1,12,13,24,5,0,5,15,40
Bryn Forbes,SG,27,42,6,789,143,308,.464,90,198,.455,53,110,.482,.610,23,31,.742,7,44,51,24,8,0,23,43,399
Trent Forrest,PG,22,10,0,34,1,5,.200,0,2,.000,1,3,.333,.200,2,2,1.000,0,5,5,7,2,0,3,2,4
Evan Fournier,SF,28,26,26,787,170,369,.461,73,188,.388,97,181,.536,.560,98,123,.797,5,70,75,95,27,9,54,55,511
De'Aaron Fox,PG,23,43,43,1493,376,792,.475,78,235,.332,298,557,.535,.524,207,299,.692,26,120,146,315,57,18,136,128,1037
Tim Frazier,PG,30,3,0,33,2,8,.250,0,2,.000,2,6,.333,.250,0,0,,0,4,4,7,1,0,3,4,4
Markelle Fultz,PG,22,8,8,215,41,104,.394,4,16,.250,37,88,.420,.413,17,19,.895,5,20,25,43,8,2,18,18,103
Wenyen Gabriel,PF,23,6,0,20,0,4,.000,0,1,.000,0,3,.000,.000,1,2,.500,2,5,7,2,0,0,3,1,1
Daniel Gafford,PF,22,31,11,383,60,87,.690,0,0,,60,87,.690,.690,27,41,.659,44,59,103,17,11,34,22,54,147
Danilo Gallinari,PF,32,32,4,751,122,293,.416,67,167,.401,55,126,.437,.531,97,104,.933,8,116,124,47,19,6,32,59,408
Langston Galloway,SG,29,31,0,347,54,113,.478,30,66,.455,24,47,.511,.611,17,17,1.000,5,28,33,23,6,0,9,20,155
Darius Garland,PG,21,35,32,1160,223,504,.442,63,155,.406,160,349,.458,.505,72,86,.837,16,62,78,205,39,3,105,83,581
Marc Gasol,C,36,35,35,703,54,134,.403,31,85,.365,23,49,.469,.519,29,36,.806,25,118,143,69,17,45,30,82,168
Rudy Gay,PF,34,34,0,738,136,332,.410,55,143,.385,81,189,.429,.492,45,57,.789,29,139,168,51,25,18,36,60,372
Paul George,SF,30,34,34,1133,269,561,.480,112,260,.431,157,301,.522,.579,111,126,.881,27,176,203,184,38,16,109,79,761
Taj Gibson,PF,35,17,0,305,28,50,.560,3,12,.250,25,38,.658,.590,12,18,.667,25,52,77,8,9,8,10,32,71
Harry Giles,C,22,23,0,272,26,64,.406,3,9,.333,23,55,.418,.430,13,18,.722,27,85,112,21,5,10,17,45,68
Shai Gilgeous-Alexander,SG,22,35,35,1180,287,565,.508,71,170,.418,216,395,.547,.571,185,229,.808,19,147,166,207,27,23,106,70,830
Anthony Gill,PF,28,13,1,72,4,12,.333,1,8,.125,3,4,.750,.375,3,4,.750,3,16,19,4,3,2,3,3,12
Rudy Gobert,C,28,43,43,1328,234,362,.646,0,2,.000,234,360,.650,.646,150,247,.607,147,428,575,54,21,128,73,103,618
Brandon Goodwin,PG,25,27,0,298,37,109,.339,15,53,.283,22,56,.393,.408,17,24,.708,3,24,27,43,10,0,15,23,106
Aaron Gordon,PF,25,25,25,736,128,293,.437,42,112,.375,86,181,.475,.509,66,105,.629,39,127,166,105,16,20,67,49,364
Eric Gordon,SG,32,27,13,789,159,367,.433,69,210,.329,90,157,.573,.527,94,114,.825,8,50,58,71,14,13,51,44,481
Devonte' Graham,PG,25,33,27,990,139,374,.372,96,255,.376,43,119,.361,.500,66,83,.795,15,73,88,169,29,2,44,47,440
Jerami Grant,SF,26,40,40,1422,307,715,.429,94,266,.353,213,449,.474,.495,229,263,.871,30,172,202,112,30,43,82,102,937
Danny Green,SF,33,44,44,1260,142,352,.403,106,272,.390,36,80,.450,.554,13,20,.650,36,124,160,75,60,37,52,79,403
Draymond Green,PF,30,38,38,1140,87,219,.397,18,74,.243,69,145,.476,.438,41,53,.774,31,218,249,319,55,30,105,121,233
JaMychal Green,PF,30,32,4,620,100,222,.450,48,119,.403,52,103,.505,.559,29,34,.853,49,123,172,26,17,10,32,87,277
Javonte Green,SG,27,25,2,345,39,71,.549,7,22,.318,32,49,.653,.599,20,30,.667,20,32,52,11,18,2,13,32,105
Jeff Green,C,34,41,21,1100,140,286,.490,55,135,.407,85,151,.563,.586,60,79,.759,22,133,155,58,23,11,30,74,395
Josh Green,SG,20,21,5,228,19,43,.442,2,12,.167,17,31,.548,.465,6,11,.545,12,28,40,11,4,1,12,17,46
Blake Griffin,PF,31,22,20,660,85,228,.373,40,126,.317,45,102,.441,.461,45,64,.703,8,103,111,77,16,3,33,45,255
Kyle Guy,PG,23,17,0,120,14,45,.311,6,25,.240,8,20,.400,.378,7,8,.875,3,12,15,15,4,0,3,9,41
Rui Hachimura,PF,22,35,35,1086,174,367,.474,32,94,.340,142,273,.520,.518,88,113,.779,32,172,204,54,27,2,39,76,468
Ashton Hagans,PG,21,2,0,4,0,0,,0,0,,0,0,,,0,0,,0,0,0,0,0,0,1,0,0
Tyrese Haliburton,PG,20,38,7,1138,188,390,.482,83,197,.421,105,193,.544,.588,32,37,.865,33,98,131,193,50,23,60,53,491
Josh Hall,SF,20,7,0,51,4,18,.222,1,8,.125,3,10,.300,.250,3,7,.429,1,8,9,7,0,0,4,7,12
R.J. Hampton,PG,19,25,0,233,25,60,.417,5,18,.278,20,42,.476,.458,9,12,.750,10,40,50,14,5,2,11,22,64
Tim Hardaway Jr.,SG,28,41,19,1208,238,536,.444,123,312,.394,115,224,.513,.559,77,98,.786,13,125,138,72,22,6,38,65,676
James Harden,PG-SG,31,38,38,1444,304,656,.463,109,304,.359,195,352,.554,.546,244,282,.865,32,270,302,427,48,28,161,87,961
Maurice Harkless,SF,27,11,3,124,5,13,.385,5,11,.455,0,2,.000,.577,0,2,.000,2,11,13,7,2,4,3,14,15
Jared Harper,PG,23,3,0,7,0,1,.000,0,0,,0,1,.000,.000,2,2,1.000,0,0,0,0,0,0,2,0,2
Montrezl Harrell,C,27,44,1,1100,266,417,.638,0,9,.000,266,408,.652,.638,119,165,.721,106,185,291,48,29,35,48,90,651
Gary Harris,SG,26,19,19,581,69,156,.442,24,75,.320,45,81,.556,.519,22,30,.733,13,34,47,32,17,4,14,37,184
Jalen Harris,SG,22,4,0,14,1,4,.250,1,2,.500,0,2,.000,.375,0,0,,1,2,3,2,1,0,1,2,3
Joe Harris,SF,29,45,41,1384,235,457,.514,148,305,.485,87,152,.572,.676,28,39,.718,23,131,154,77,27,10,37,99,646
Tobias Harris,PF,28,39,39,1327,311,612,.508,62,150,.413,249,462,.539,.559,127,142,.894,45,254,299,140,35,32,73,76,811
Shaquille Harrison,SG,27,17,0,56,6,20,.300,0,2,.000,6,18,.333,.300,5,6,.833,3,6,9,9,2,0,5,3,17
Josh Hart,SF,25,43,3,1216,139,312,.446,57,174,.328,82,138,.594,.537,58,77,.753,48,279,327,96,37,10,40,98,393
Isaiah Hartenstein,C,22,30,0,272,41,80,.513,0,0,,41,80,.513,.513,22,36,.611,40,45,85,15,11,20,21,59,104
Jaxson Hayes,C,20,32,1,430,70,97,.722,0,0,,70,97,.722,.722,37,49,.755,36,75,111,16,11,16,19,59,177
Killian Hayes,PG,19,7,7,148,13,47,.277,5,20,.250,8,27,.296,.330,1,2,.500,1,7,8,25,2,0,17,15,32
Gordon Hayward,SF,30,39,39,1329,285,593,.481,77,185,.416,208,408,.510,.546,138,159,.868,31,189,220,162,50,13,82,68,785
Juan Hernangómez,PF,25,25,6,433,59,138,.428,25,76,.329,34,62,.548,.518,22,34,.647,21,85,106,15,9,2,13,24,165
Willy Hernangómez,C,26,24,2,378,63,121,.521,1,7,.143,62,114,.544,.525,24,38,.632,59,89,148,28,7,11,11,28,151
Tyler Herro,SG,21,33,14,1048,186,449,.414,58,186,.312,128,263,.487,.479,68,83,.819,17,162,179,113,22,13,74,47,498
Buddy Hield,SG,28,44,44,1545,250,636,.393,177,463,.382,73,173,.422,.532,62,73,.849,18,184,202,143,34,15,77,115,739
George Hill,PG,34,14,14,369,61,120,.508,22,57,.386,39,63,.619,.600,21,25,.840,8,21,29,43,12,2,12,12,165
Solomon Hill,PF,29,43,1,813,60,169,.355,41,127,.323,19,42,.452,.476,18,21,.857,23,74,97,37,29,6,27,70,179
Nate Hinton,SG,21,8,0,30,5,16,.313,1,6,.167,4,10,.400,.344,2,4,.500,0,2,2,3,2,1,4,1,13
Aaron Holiday,PG,24,41,6,738,105,284,.370,40,121,.331,65,163,.399,.440,34,45,.756,8,42,50,71,26,5,32,68,284
Jrue Holiday,PG,30,33,30,1035,208,426,.488,57,152,.375,151,274,.551,.555,50,62,.806,40,108,148,169,58,17,57,57,523
Justin Holiday,SG,31,43,34,1387,170,390,.436,112,285,.393,58,105,.552,.579,48,59,.814,25,138,163,73,53,16,35,90,500
Richaun Holmes,C,27,40,40,1207,239,369,.648,2,8,.250,237,361,.657,.650,80,98,.816,102,248,350,72,29,63,50,155,560
Rodney Hood,SF,28,38,5,726,73,201,.363,25,84,.298,48,117,.410,.425,9,12,.750,18,55,73,47,20,4,31,59,180
Al Horford,C,34,28,28,782,162,360,.450,56,152,.368,106,208,.510,.528,18,22,.818,29,159,188,94,25,26,29,48,398
Talen Horton-Tucker,SG,20,40,1,735,126,281,.448,19,75,.253,107,206,.519,.482,50,59,.847,17,89,106,93,32,20,54,79,321
Danuel House,SF,27,27,17,755,92,223,.413,45,125,.360,47,98,.480,.513,32,47,.681,18,92,110,54,17,13,25,54,261
Dwight Howard,C,35,44,4,761,111,196,.566,4,14,.286,107,182,.588,.577,65,121,.537,113,247,360,33,19,41,78,131,291
Markus Howard,SG,21,21,0,71,9,38,.237,5,27,.185,4,11,.364,.303,1,2,.500,0,7,7,7,2,0,5,10,24
Kevin Huerter,SG,22,44,33,1386,196,466,.421,93,253,.368,103,213,.484,.520,35,42,.833,31,129,160,155,56,11,56,109,520
Elijah Hughes,SF,22,8,0,32,6,17,.353,4,12,.333,2,5,.400,.471,3,4,.750,0,6,6,4,1,1,4,0,19
De'Andre Hunter,SF,23,20,18,625,112,223,.502,31,87,.356,81,136,.596,.572,65,75,.867,16,86,102,42,18,10,27,53,320
Chandler Hutchison,SF,24,7,0,64,5,18,.278,1,3,.333,4,15,.267,.306,2,2,1.000,1,19,20,4,1,0,5,9,13
Serge Ibaka,C,31,39,39,919,176,347,.507,38,108,.352,138,239,.577,.562,37,45,.822,68,193,261,68,9,46,44,74,427
Andre Iguodala,SF,37,40,2,853,63,161,.391,42,122,.344,21,39,.538,.522,18,29,.621,24,122,146,85,40,19,40,54,186
Ersan İlyasova,F,33,2,0,6,0,1,.000,0,1,.000,0,0,,.000,0,0,,1,1,2,1,0,0,1,0,0
Joe Ingles,SF,33,39,10,1044,163,303,.538,106,216,.491,57,87,.655,.713,40,45,.889,16,128,144,164,22,9,57,68,472
Brandon Ingram,SF,23,43,43,1475,371,775,.479,104,273,.381,267,502,.532,.546,194,220,.882,25,193,218,203,28,31,104,87,1040
Kyrie Irving,PG,28,31,31,1104,334,642,.520,89,219,.406,245,423,.579,.590,114,128,.891,36,114,150,177,37,18,74,85,871
Wesley Iwundu,SF,26,23,3,288,17,52,.327,3,23,.130,14,29,.483,.356,12,14,.857,6,38,44,10,9,3,6,26,49
Frank Jackson,PG,22,14,4,173,25,60,.417,12,30,.400,13,30,.433,.517,6,8,.750,4,14,18,11,4,0,10,13,68
Josh Jackson,SG,23,39,6,969,185,438,.422,45,161,.280,140,277,.505,.474,97,136,.713,38,125,163,83,35,33,84,112,512
Justin Jackson,SF,25,30,3,491,76,182,.418,29,95,.305,47,87,.540,.497,28,33,.848,12,53,65,46,13,2,29,29,209
Reggie Jackson,SG,30,42,22,859,136,304,.447,57,141,.404,79,163,.485,.541,35,47,.745,13,98,111,120,24,3,40,77,364
Justin James,SF,24,21,0,132,16,37,.432,4,13,.308,12,24,.500,.486,5,12,.417,3,8,11,10,3,1,5,8,41
LeBron James,PG,36,41,41,1388,388,756,.513,98,266,.368,290,490,.592,.578,168,239,.703,24,299,323,323,43,24,152,65,1042
DaQuan Jeffries,SG,23,15,2,206,22,54,.407,8,26,.308,14,28,.500,.481,6,7,.857,7,17,24,4,6,4,7,21,58
Ty Jerome,SG,23,12,1,314,45,99,.455,28,63,.444,17,36,.472,.596,2,5,.400,7,34,41,43,9,2,10,26,120
Isaiah Joe,SG,21,22,1,253,31,86,.360,24,66,.364,7,20,.350,.500,5,5,1.000,6,20,26,15,7,4,5,22,91
Alize Johnson,F,24,1,0,33,11,15,.733,0,1,.000,11,14,.786,.733,1,1,1.000,5,10,15,3,2,0,1,1,23
Cameron Johnson,PF,24,37,9,876,132,300,.440,78,203,.384,54,97,.557,.570,32,37,.865,20,101,121,49,23,13,27,53,374
James Johnson,PF,33,29,1,504,67,145,.462,15,60,.250,52,85,.612,.514,17,29,.586,14,72,86,50,24,23,27,59,166
Keldon Johnson,SF,21,38,36,1106,196,415,.472,35,106,.330,161,309,.521,.514,92,120,.767,63,182,245,76,24,22,47,86,519
Stanley Johnson,PF,24,39,6,544,38,102,.373,24,67,.358,14,35,.400,.490,11,14,.786,18,65,83,44,27,10,25,66,111
Tyler Johnson,SG,28,26,2,411,46,115,.400,30,79,.380,16,36,.444,.530,16,19,.842,4,43,47,23,9,0,8,24,138
Nikola Jokić,C,25,44,44,1571,465,815,.571,67,159,.421,398,656,.607,.612,189,217,.871,129,366,495,376,70,27,136,122,1186
Damian Jones,C,25,22,6,206,24,33,.727,0,1,.000,24,32,.750,.727,17,23,.739,15,29,44,5,2,12,11,41,65
Derrick Jones Jr.,SF,23,39,38,1036,116,235,.494,34,105,.324,82,130,.631,.566,46,71,.648,65,105,170,36,31,41,26,96,312
Mason Jones,SG,22,26,1,307,47,114,.412,23,64,.359,24,50,.480,.513,35,57,.614,4,47,51,39,6,1,28,22,152
Tre Jones,PG,21,19,0,86,15,30,.500,1,1,1.000,14,29,.483,.517,5,5,1.000,5,4,9,8,2,0,7,5,36
Tyus Jones,PG,24,41,8,823,126,289,.436,28,96,.292,98,193,.508,.484,24,27,.889,15,74,89,172,46,4,33,20,304
DeAndre Jordan,C,32,43,33,978,145,188,.771,0,1,.000,145,187,.775,.771,32,65,.492,84,235,319,74,14,55,66,91,322
Cory Joseph,PG,29,44,2,944,111,250,.444,31,94,.330,80,156,.513,.506,36,47,.766,25,74,99,108,39,9,44,98,289
Mfiondu Kabengele,PF,23,23,0,94,9,32,.281,4,18,.222,5,14,.357,.344,5,6,.833,1,13,14,5,2,3,6,18,27
Frank Kaminsky,C,27,32,13,483,82,174,.471,26,64,.406,56,110,.509,.546,20,33,.606,22,96,118,52,10,13,15,42,210
Enes Kanter,C,28,43,31,1146,217,363,.598,0,1,.000,217,362,.599,.598,86,111,.775,183,317,500,55,22,30,50,114,520
Luke Kennard,SG,24,39,7,753,117,237,.494,63,131,.481,54,106,.509,.627,13,15,.867,11,95,106,70,14,7,29,56,310
Maxi Kleber,PF,29,30,24,831,75,160,.469,57,121,.471,18,39,.462,.647,27,29,.931,29,133,162,41,14,23,17,68,234
Nathan Knight,PF,23,16,0,125,20,45,.444,5,14,.357,15,31,.484,.500,20,22,.909,16,18,34,4,4,6,10,13,65
Kevin Knox,SF,21,30,0,410,49,123,.398,30,75,.400,19,48,.396,.520,11,14,.786,9,42,51,17,8,6,16,34,139
John Konchar,SG,24,21,0,320,30,68,.441,9,25,.360,21,43,.488,.507,16,18,.889,18,51,69,23,19,5,8,26,85
Furkan Korkmaz,SG,23,33,5,647,103,254,.406,58,157,.369,45,97,.464,.520,41,55,.745,10,62,72,36,24,5,31,39,305
Luke Kornet,PF,25,13,0,94,9,27,.333,6,23,.261,3,4,.750,.444,2,4,.500,1,14,15,4,2,7,1,1,26
Rodions Kurucs,SF-PF,22,16,0,91,6,24,.250,3,17,.176,3,7,.429,.313,1,2,.500,2,12,14,6,6,4,9,8,16
Kyle Kuzma,SF,25,43,13,1155,202,456,.443,84,224,.375,118,232,.509,.535,31,50,.620,83,204,287,64,20,24,68,74,519
Anthony Lamb,SF,23,7,0,108,6,30,.200,3,17,.176,3,13,.231,.250,3,4,.750,12,15,27,2,1,1,2,14,18
Jeremy Lamb,SG,28,26,8,573,92,203,.453,42,96,.438,50,107,.467,.557,58,61,.951,18,74,92,43,20,13,17,54,284
Zach LaVine,SG,25,43,43,1518,432,831,.520,152,348,.437,280,483,.580,.611,192,221,.869,27,190,217,210,39,20,163,107,1208
Jake Layman,SF,26,32,10,525,75,153,.490,19,65,.292,56,88,.636,.552,23,30,.767,13,48,61,26,25,16,23,36,192
Jalen Lecque,PG,20,4,0,12,1,9,.111,0,1,.000,1,8,.125,.111,3,3,1.000,2,3,5,2,0,0,0,0,5
Damion Lee,SG,28,43,1,820,97,214,.453,61,159,.384,36,55,.655,.596,33,37,.892,16,124,140,61,26,6,20,61,288
Saben Lee,PG,21,22,0,316,43,85,.506,4,7,.571,39,78,.500,.529,31,47,.660,8,25,33,59,13,5,18,35,121
Alex Len,C,27,34,12,494,80,125,.640,6,20,.300,74,105,.705,.664,41,67,.612,27,94,121,32,9,39,31,62,207
Kawhi Leonard,SF,29,37,37,1274,347,672,.516,74,185,.400,273,487,.561,.571,191,218,.876,35,199,234,178,66,18,69,62,959
Meyers Leonard,C,28,3,2,29,3,7,.429,3,7,.429,0,0,,.643,1,2,.500,0,7,7,2,0,0,2,5,10
Caris LeVert,SG,26,19,11,556,130,306,.425,37,106,.349,93,200,.465,.485,42,53,.792,15,67,82,100,24,6,36,33,339
Kira Lewis Jr.,PG,19,28,0,401,63,159,.396,19,56,.339,44,103,.427,.456,18,25,.720,4,22,26,57,20,4,13,35,163
Damian Lillard,PG,30,42,42,1514,391,865,.452,179,474,.378,212,391,.542,.555,305,324,.941,20,163,183,322,38,10,138,66,1266
Nassir Little,PF,20,27,2,366,46,99,.465,21,54,.389,25,45,.556,.571,30,35,.857,21,48,69,12,4,9,11,32,143
Kevon Looney,C,24,33,15,498,53,88,.602,4,9,.444,49,79,.620,.625,20,27,.741,54,84,138,54,14,13,21,65,130
Brook Lopez,C,32,43,43,1174,180,381,.472,64,192,.333,116,189,.614,.556,70,84,.833,60,156,216,31,26,59,40,88,494
Robin Lopez,C,32,42,9,839,137,236,.581,5,15,.333,132,221,.597,.591,65,93,.699,94,79,173,36,12,24,44,78,344
Kevin Love,PF,32,4,4,58,7,22,.318,4,12,.333,3,10,.300,.409,5,7,.714,2,11,13,5,1,0,3,3,23
Kyle Lowry,PG,34,37,37,1289,213,485,.439,103,261,.395,110,224,.491,.545,114,129,.884,33,173,206,276,39,10,109,117,643
Timothé Luwawu-Cabarrot,SF,25,38,7,738,95,248,.383,57,162,.352,38,86,.442,.498,23,30,.767,18,74,92,48,27,5,32,69,270
Trey Lyles,PF,25,23,9,358,43,90,.478,14,40,.350,29,50,.580,.556,15,23,.652,9,77,86,14,6,1,6,13,115
Will Magnay,C,22,1,0,3,0,1,.000,0,1,.000,0,0,,.000,0,0,,0,0,0,0,0,0,1,1,0
Thon Maker,C,23,8,0,76,10,18,.556,0,2,.000,10,16,.625,.556,10,11,.909,8,10,18,4,2,4,3,7,30
Théo Maledon,PG,19,38,22,1014,112,292,.384,61,164,.372,51,128,.398,.488,26,36,.722,13,105,118,129,36,3,73,84,311
Karim Mané,PG,20,7,0,60,1,9,.111,1,2,.500,0,7,.000,.167,4,4,1.000,0,10,10,1,0,1,3,3,7
Terance Mann,SG,24,42,3,696,84,172,.488,17,44,.386,67,128,.523,.538,41,52,.788,34,114,148,51,17,9,26,72,226
Nico Mannion,PG,19,14,1,182,20,61,.328,11,32,.344,9,29,.310,.418,10,14,.714,2,23,25,37,10,0,14,19,61
Boban Marjanović,C,32,20,1,151,38,77,.494,0,4,.000,38,73,.521,.494,12,16,.750,30,48,78,4,1,2,8,16,88
Lauri Markkanen,PF,23,23,23,691,146,303,.482,64,164,.390,82,139,.590,.587,51,61,.836,19,117,136,22,13,11,30,43,407
Naji Marshall,SF,23,6,0,20,1,6,.167,0,2,.000,1,4,.250,.167,1,2,.500,0,2,2,2,0,1,1,1,3
Caleb Martin,SF,25,30,1,427,58,144,.403,20,63,.317,38,81,.469,.472,22,37,.595,20,55,75,31,25,7,20,31,158
Cody Martin,SF,25,31,2,412,50,101,.495,9,32,.281,41,69,.594,.540,14,20,.700,28,51,79,38,15,5,19,26,123
Kelan Martin,SF,25,14,0,54,7,21,.333,2,9,.222,5,12,.417,.381,2,2,1.000,1,11,12,1,3,1,4,5,18
Kenyon Martin Jr.,SF,20,16,0,305,44,91,.484,7,19,.368,37,72,.514,.522,21,28,.750,31,41,72,12,11,16,18,28,116
Frank Mason III,PG,26,4,1,79,9,24,.375,2,5,.400,7,19,.368,.417,5,7,.714,3,9,12,12,0,0,5,7,25
Garrison Mathews,SG,24,36,20,630,66,156,.423,51,125,.408,15,31,.484,.587,57,64,.891,12,49,61,15,22,6,5,65,240
Dakota Mathias,SG,25,8,2,123,19,48,.396,8,26,.308,11,22,.500,.479,2,6,.333,1,6,7,13,1,3,1,7,48
Wesley Matthews,SG,34,37,5,743,55,153,.359,42,121,.347,13,32,.406,.497,13,16,.813,12,41,53,37,19,13,17,55,165
Tyrese Maxey,SG,20,38,6,579,123,267,.461,17,59,.288,106,208,.510,.493,23,27,.852,9,57,66,62,15,6,25,46,286
Skylar Mays,SG,23,19,0,141,20,51,.392,8,23,.348,12,28,.429,.471,16,18,.889,7,8,15,19,6,0,5,8,64
Patrick McCaw,SF,25,5,0,33,1,1,1.000,0,0,,1,1,1.000,1.000,3,3,1.000,1,2,3,4,2,0,0,6,5
CJ McCollum,SG,29,18,18,576,151,344,.439,79,186,.425,72,158,.456,.554,48,55,.873,10,58,68,78,19,5,20,32,429
T.J. McConnell,PG,28,40,2,1012,133,244,.545,7,22,.318,126,222,.568,.559,13,23,.565,29,117,146,260,72,15,74,62,286
Jaden McDaniels,PF,20,37,3,742,79,192,.411,35,102,.343,44,90,.489,.503,12,26,.462,24,100,124,36,18,36,25,89,205
Jalen McDaniels,SF,23,21,1,234,33,75,.440,8,28,.286,25,47,.532,.493,15,21,.714,8,39,47,10,2,5,17,32,89
Doug McDermott,PF,29,42,16,1061,220,428,.514,69,187,.369,151,241,.627,.595,54,65,.831,44,118,162,57,12,4,37,73,563
Sean McDermott,SF,24,9,0,131,11,25,.440,5,16,.313,6,9,.667,.540,6,6,1.000,4,8,12,4,2,2,4,6,33
JaVale McGee,C,33,33,1,503,112,215,.521,5,20,.250,107,195,.549,.533,36,55,.655,54,116,170,33,16,40,45,80,265
Rodney McGruder,SG,29,15,1,178,34,67,.507,10,23,.435,24,44,.545,.582,6,8,.750,8,13,21,15,7,1,7,11,84
Alfonzo McKinnie,SF,28,23,0,122,22,40,.550,8,19,.421,14,21,.667,.650,5,8,.625,8,18,26,2,2,0,2,13,57
Jordan McLaughlin,PG,24,24,0,467,53,141,.376,16,46,.348,37,95,.389,.433,8,10,.800,13,43,56,113,24,4,26,24,130
Ben McLemore,SG,27,29,3,471,67,194,.345,44,142,.310,23,52,.442,.459,21,29,.724,11,51,62,25,18,3,26,43,199
Nicolò Melli,PF,30,22,0,241,15,59,.254,7,37,.189,8,22,.364,.314,6,7,.857,12,45,57,25,9,1,7,28,43
De'Anthony Melton,PG,22,29,1,575,108,229,.472,48,113,.425,60,116,.517,.576,20,27,.741,19,79,98,81,37,16,36,51,284
Sam Merrill,SG,24,17,0,97,11,24,.458,8,16,.500,3,8,.375,.625,2,2,1.000,4,11,15,11,2,0,5,8,32
Chimezie Metu,C,23,12,0,80,18,35,.514,2,6,.333,16,29,.552,.543,6,9,.667,11,12,23,5,3,6,7,14,44
Khris Middleton,SF,29,43,43,1440,326,665,.490,96,223,.430,230,442,.520,.562,136,155,.877,35,231,266,234,46,7,120,106,884
Darius Miller,SF,30,14,0,145,14,31,.452,11,27,.407,3,4,.750,.629,9,9,1.000,1,18,19,16,9,4,6,9,48
Patty Mills,PG,32,40,0,1025,182,411,.443,109,276,.395,73,135,.541,.575,49,54,.907,12,58,70,102,29,1,42,51,522
Paul Millsap,PF,35,34,33,798,121,239,.506,36,96,.375,85,143,.594,.582,46,67,.687,50,121,171,59,32,22,30,71,324
Shake Milton,SG,24,36,2,895,181,406,.446,35,115,.304,146,291,.502,.489,101,117,.863,20,61,81,112,23,10,59,83,498
Donovan Mitchell,SG,24,41,41,1389,356,828,.430,137,357,.384,219,471,.465,.513,193,231,.835,40,149,189,225,42,11,121,93,1042
Adam Mokoka,SG,22,9,0,47,6,15,.400,1,8,.125,5,7,.714,.433,0,0,,1,3,4,4,2,1,2,5,13
Malik Monk,SG,22,30,0,647,132,294,.449,62,151,.411,70,143,.490,.554,50,62,.806,11,69,80,57,14,3,44,37,376
E'Twaun Moore,SG,31,24,1,348,43,102,.422,8,29,.276,35,73,.479,.461,8,10,.800,13,29,42,35,14,4,18,31,102
Ja Morant,PG,21,33,33,1040,228,522,.437,27,118,.229,201,404,.498,.463,147,192,.766,29,83,112,246,31,7,97,49,630
Juwan Morgan,PF,23,18,0,78,7,16,.438,3,10,.300,4,6,.667,.531,1,5,.200,5,10,15,4,4,0,2,13,18
Marcus Morris,PF,31,35,7,868,153,343,.446,83,181,.459,70,162,.432,.567,42,50,.840,24,109,133,37,18,10,28,71,431
Markieff Morris,PF,31,38,14,691,82,201,.408,39,118,.331,43,83,.518,.505,27,38,.711,28,133,161,40,9,11,25,65,230
Monte Morris,PG,25,36,10,980,144,306,.471,40,114,.351,104,192,.542,.536,48,63,.762,7,71,78,123,26,10,25,36,376
Mychal Mulder,PG,26,36,2,379,48,115,.417,39,99,.394,9,16,.563,.587,10,17,.588,1,32,33,16,8,7,8,27,145
Dejounte Murray,PG,24,40,40,1251,256,569,.450,38,122,.311,218,447,.488,.483,69,85,.812,27,251,278,205,59,4,69,82,619
Jamal Murray,PG,23,42,42,1487,328,688,.477,114,275,.415,214,413,.518,.560,116,135,.859,32,134,166,202,54,11,95,88,886
Mike Muscala,C,29,35,0,645,119,267,.446,68,184,.370,51,83,.614,.573,33,36,.917,19,113,132,28,8,11,21,54,339
Sviatoslav Mykhailiuk,SF,23,40,5,704,97,253,.383,63,190,.332,34,63,.540,.508,24,30,.800,12,71,83,65,32,6,45,35,281
Abdel Nader,SF,27,24,0,355,57,116,.491,18,43,.419,39,73,.534,.569,28,37,.757,7,55,62,19,10,9,19,34,160
Larry Nance Jr.,PF,28,27,25,889,102,211,.483,33,89,.371,69,122,.566,.562,21,33,.636,42,144,186,81,50,16,40,56,258
Aaron Nesmith,SF,21,22,0,337,29,74,.392,20,55,.364,9,19,.474,.527,10,14,.714,12,41,53,8,5,5,12,42,88
Raul Neto,PG,28,37,6,764,108,249,.434,34,94,.362,74,155,.477,.502,35,42,.833,14,69,83,83,44,3,28,56,285
Georges Niang,PF,27,43,0,584,83,199,.417,53,140,.379,30,59,.508,.550,5,5,1.000,14,77,91,31,13,5,26,65,224
Zeke Nnaji,PF,20,29,1,315,41,80,.513,17,44,.386,24,36,.667,.619,10,13,.769,13,37,50,5,4,3,7,22,109
Nerlens Noel,C,26,39,17,872,82,131,.626,0,2,.000,82,129,.636,.626,25,38,.658,83,150,233,25,38,77,43,99,189
Jaylen Nowell,SG,21,30,0,571,118,253,.466,43,112,.384,75,141,.532,.551,36,43,.837,14,52,66,44,15,10,21,61,315
Frank Ntilikina,PG,22,16,3,235,23,62,.371,17,36,.472,6,26,.231,.508,6,12,.500,3,16,19,13,14,1,9,30,69
Kendrick Nunn,PG,25,36,24,1037,185,414,.447,72,199,.362,113,215,.526,.534,38,41,.927,16,98,114,95,38,9,58,65,480
Jusuf Nurkić,C,26,12,12,280,50,103,.485,3,12,.250,47,91,.516,.500,15,27,.556,23,69,92,33,11,11,23,33,118
David Nwaba,SF,28,30,9,679,106,218,.486,17,63,.270,89,155,.574,.525,47,68,.691,40,78,118,31,30,21,17,60,276
Jordan Nwora,SF,22,12,0,87,18,39,.462,8,16,.500,10,23,.435,.564,10,11,.909,1,15,16,0,4,3,11,10,54
Royce O'Neale,SF,27,43,43,1386,110,244,.451,74,178,.416,36,66,.545,.602,27,32,.844,52,233,285,110,36,22,51,121,321
Semi Ojeleye,PF,26,40,9,765,71,174,.408,49,125,.392,22,49,.449,.549,22,30,.733,25,92,117,30,11,0,16,44,213
Jahlil Okafor,C,25,12,0,120,25,42,.595,0,3,.000,25,39,.641,.595,1,2,.500,13,14,27,3,2,2,4,10,51
Chuma Okeke,PF,22,28,2,607,50,127,.394,26,68,.382,24,59,.407,.496,10,16,.625,23,75,98,51,21,10,18,29,136
Josh Okogie,SG,22,36,21,713,55,157,.350,15,66,.227,40,91,.440,.398,48,59,.814,33,59,92,43,33,15,26,75,173
Onyeka Okongwu,C,20,22,1,194,26,44,.591,0,1,.000,26,43,.605,.591,9,15,.600,16,33,49,5,7,11,9,32,61
Isaac Okoro,SG,20,39,39,1258,117,280,.418,34,111,.306,83,169,.491,.479,45,65,.692,37,72,109,71,43,19,56,111,313
KZ Okpala,PF,21,25,9,322,27,66,.409,11,37,.297,16,29,.552,.492,2,6,.333,15,35,50,11,6,8,12,44,67
Victor Oladipo,SG,28,29,29,969,219,533,.411,74,222,.333,145,311,.466,.480,92,120,.767,9,137,146,137,39,12,69,68,604
Kelly Olynyk,C,29,43,38,1157,162,376,.431,77,243,.317,85,133,.639,.533,31,40,.775,44,217,261,91,40,26,55,123,432
Miye Oni,SG,23,30,0,233,19,48,.396,17,41,.415,2,7,.286,.573,5,6,.833,14,34,48,8,3,5,7,33,60
Cedi Osman,SF,25,43,16,1077,153,431,.355,76,246,.309,77,185,.416,.443,51,65,.785,28,124,152,116,41,6,45,80,433
Daniel Oturu,C,21,14,0,68,11,21,.524,0,1,.000,11,20,.550,.524,2,4,.500,7,11,18,6,1,3,4,10,24
Kelly Oubre Jr.,SF,25,42,42,1281,238,544,.438,66,216,.306,172,328,.524,.498,92,131,.702,58,189,247,58,44,34,53,94,634
Jabari Parker,PF,25,3,0,27,4,7,.571,0,1,.000,4,6,.667,.571,0,0,,1,5,6,1,0,1,3,4,8
Eric Paschall,PF,24,37,2,645,138,280,.493,15,49,.306,123,231,.532,.520,61,85,.718,27,90,117,49,11,6,39,64,352
Anžejs Pasečņiks,C,25,1,0,6,0,1,.000,0,1,.000,0,0,,.000,0,0,,1,0,1,1,0,0,5,2,0
Patrick Patterson,PF,31,16,1,198,26,60,.433,14,40,.350,12,20,.600,.550,4,6,.667,7,24,31,9,5,2,8,20,70
Justin Patton,C,23,12,6,242,28,67,.418,9,32,.281,19,35,.543,.485,3,4,.750,14,34,48,14,12,14,4,34,68
Chris Paul,PG,35,42,42,1331,252,519,.486,58,155,.374,194,364,.533,.541,105,111,.946,17,182,199,367,57,11,97,104,667
Cameron Payne,PG,26,32,0,547,82,171,.480,33,78,.423,49,93,.527,.576,25,28,.893,6,61,67,117,18,7,35,53,222
Elfrid Payton,PG,26,35,35,977,181,415,.436,16,64,.250,165,351,.470,.455,57,78,.731,47,88,135,129,26,7,63,67,435
Norvel Pelle,C,27,4,0,32,3,8,.375,0,0,,3,8,.375,.375,3,4,.750,4,4,8,1,0,3,3,10,9
Reggie Perry,PF,20,15,0,175,25,60,.417,4,16,.250,21,44,.477,.450,8,11,.727,19,40,59,13,4,5,12,29,62
Theo Pinson,SG,25,13,0,28,1,8,.125,0,7,.000,1,1,1.000,.125,0,0,,0,2,2,1,0,0,1,3,2
Mason Plumlee,C,30,41,41,1135,171,281,.609,0,6,.000,171,275,.622,.609,81,124,.653,114,276,390,149,36,37,82,142,423
Jakob Poeltl,C,25,41,23,993,134,217,.618,0,0,,134,217,.618,.618,22,59,.373,126,190,316,74,24,64,53,93,290
Vincent Poirier,C,27,10,0,39,3,12,.250,0,1,.000,3,11,.273,.250,2,6,.333,6,8,14,2,0,3,4,8,8
Aleksej Pokusevski,PF,19,25,8,546,52,178,.292,23,97,.237,29,81,.358,.357,13,14,.929,17,103,120,42,11,26,39,27,140
Jordan Poole,SG,21,23,3,367,85,176,.483,38,100,.380,47,76,.618,.591,40,43,.930,3,34,37,33,8,3,14,28,248
Jontay Porter,PF,21,1,0,3,0,2,.000,0,1,.000,0,1,.000,.000,0,0,,1,2,3,0,0,0,0,1,0
Kevin Porter Jr.,SG,20,7,4,204,41,98,.418,9,43,.209,32,55,.582,.464,13,20,.650,1,18,19,45,9,5,22,13,104
Michael Porter Jr.,SF,22,34,27,1000,206,392,.526,81,189,.429,125,203,.616,.629,52,69,.754,50,201,251,29,24,32,36,73,545
Otto Porter,SF,27,25,6,540,89,202,.441,38,95,.400,51,107,.477,.535,31,37,.838,28,110,138,50,12,4,25,37,247
Bobby Portis,C,25,43,2,903,199,370,.538,49,102,.480,150,268,.560,.604,28,38,.737,76,217,293,46,33,17,34,79,475
Kristaps Porziņģis,C,25,27,27,818,203,423,.480,61,166,.367,142,257,.553,.552,74,87,.851,48,184,232,38,11,43,35,74,541
Dwight Powell,C,29,29,8,425,44,88,.500,3,13,.231,41,75,.547,.517,49,64,.766,32,67,99,24,15,10,17,66,140
Norman Powell,SG,27,42,31,1277,282,566,.498,118,269,.439,164,297,.552,.602,141,163,.865,19,107,126,77,47,8,77,98,823
Taurean Prince,PF,26,29,10,620,79,208,.380,39,101,.386,40,107,.374,.474,45,53,.849,15,89,104,50,19,19,31,53,242
Payton Pritchard,SG,23,38,1,750,100,222,.450,51,124,.411,49,98,.500,.565,18,20,.900,20,57,77,79,20,6,36,70,269
Immanuel Quickley,PG,21,39,3,773,155,392,.395,75,200,.375,80,192,.417,.491,112,126,.889,17,70,87,88,18,9,38,80,497
Jahmi'us Ramsey,SG,19,5,0,17,3,5,.600,1,3,.333,2,2,1.000,.700,0,0,,0,4,4,1,0,1,1,0,7
Chasson Randle,PG,27,15,2,307,27,64,.422,15,42,.357,12,22,.545,.539,13,16,.813,2,28,30,38,5,1,15,25,82
Julius Randle,PF,26,44,44,1631,366,775,.472,89,208,.428,277,567,.489,.530,203,257,.790,65,414,479,259,40,10,146,136,1024
Cam Reddish,SF,21,26,21,750,96,263,.365,33,126,.262,63,137,.460,.428,67,82,.817,22,82,104,35,33,9,34,68,292
J.J. Redick,SG,36,31,0,576,87,214,.407,51,140,.364,36,74,.486,.526,45,47,.957,3,49,52,40,9,2,25,37,270
Paul Reed,PF,21,7,0,64,11,24,.458,0,3,.000,11,21,.524,.458,0,0,,7,5,12,3,1,5,5,4,22
Naz Reid,C,21,42,13,826,185,352,.526,36,105,.343,149,247,.603,.577,70,99,.707,46,149,195,50,25,47,48,115,476
Nick Richards,PF,23,11,0,38,3,6,.500,0,0,,3,6,.500,.500,7,11,.636,2,6,8,0,0,0,1,5,13
Josh Richardson,SG,27,33,33,1056,155,345,.449,53,164,.323,102,181,.564,.526,72,77,.935,31,81,112,89,32,12,48,87,435
Austin Rivers,SG,28,21,2,442,58,135,.430,28,77,.364,30,58,.517,.533,10,14,.714,5,42,47,42,12,0,22,32,154
Andre Roberson,SG,29,5,0,63,2,14,.143,1,8,.125,1,6,.167,.179,1,2,.500,7,8,15,4,3,1,2,4,6
Duncan Robinson,SF,26,44,44,1451,182,438,.416,143,374,.382,39,64,.609,.579,44,53,.830,4,164,168,73,25,10,52,105,551
Glenn Robinson III,SF,27,23,2,369,42,99,.424,16,44,.364,26,55,.473,.505,21,23,.913,11,34,45,20,4,3,11,23,121
Jerome Robinson,SG,23,13,3,221,22,67,.328,9,31,.290,13,36,.361,.396,15,17,.882,2,31,33,18,6,2,11,21,68
Mitchell Robinson,C,22,29,27,825,112,170,.659,0,0,,112,170,.659,.659,24,50,.480,108,136,244,17,32,44,24,83,248
Isaiah Roby,PF,22,38,18,869,131,252,.520,21,62,.339,110,190,.579,.562,59,79,.747,59,150,209,66,33,25,62,104,342
Rajon Rondo,PG,34,27,2,402,44,110,.400,17,45,.378,27,65,.415,.477,1,2,.500,4,51,55,95,19,2,39,25,106
Derrick Rose,PG,32,25,3,588,126,293,.430,23,61,.377,103,232,.444,.469,63,74,.851,7,48,55,112,29,10,48,29,338
Terrence Ross,SG,29,36,2,1066,205,495,.414,81,225,.360,124,270,.459,.496,84,94,.894,12,115,127,81,39,17,61,68,575
Terry Rozier,SG,26,41,41,1352,295,619,.477,136,324,.420,159,295,.539,.586,108,127,.850,20,133,153,136,55,13,75,72,834
Ricky Rubio,PG,30,42,27,1107,120,299,.401,35,112,.313,85,187,.455,.460,88,105,.838,19,113,132,286,55,1,83,93,363
D'Angelo Russell,PG,24,20,19,583,139,326,.426,59,148,.399,80,178,.449,.517,48,64,.750,9,43,52,101,22,10,54,39,385
Domantas Sabonis,PF,24,43,43,1554,327,626,.522,34,111,.306,293,515,.569,.550,175,242,.723,107,375,482,265,51,25,146,150,863
Luka Šamanić,PF,21,14,1,143,23,48,.479,8,25,.320,15,23,.652,.563,9,17,.529,8,28,36,4,4,3,9,14,63
JaKarr Sampson,PF,27,15,0,97,15,32,.469,1,5,.200,14,27,.519,.484,8,10,.800,8,21,29,1,2,3,6,11,39
Dario Šarić,C,26,25,0,464,91,196,.464,28,79,.354,63,117,.538,.536,40,45,.889,21,85,106,32,14,3,37,57,250
Tomáš Satoranský,SG,29,32,7,721,89,172,.517,25,61,.410,64,111,.577,.590,42,46,.913,13,68,81,152,21,9,54,43,245
Dennis Schröder,SG,27,40,40,1258,206,478,.431,40,126,.317,166,352,.472,.473,148,178,.831,21,118,139,187,41,9,101,108,600
Mike Scott,PF,32,25,4,416,33,87,.379,23,67,.343,10,20,.500,.511,6,10,.600,6,58,64,13,12,2,14,30,95
Collin Sexton,SG,22,38,38,1363,334,699,.478,66,169,.391,268,530,.506,.525,177,219,.808,27,78,105,162,42,4,108,104,911
Landry Shamet,SG,23,39,1,785,99,253,.391,71,190,.374,28,63,.444,.532,36,43,.837,8,62,70,43,19,5,27,50,305
Iman Shumpert,SG,30,2,0,11,1,4,.250,0,3,.000,1,1,1.000,.250,0,0,,1,0,1,0,1,0,1,0,2
Pascal Siakam,PF,26,35,35,1234,255,569,.448,45,148,.304,210,421,.499,.488,144,176,.818,64,191,255,166,40,24,73,110,699
Chris Silva,PF,24,11,0,83,9,13,.692,1,1,1.000,8,12,.667,.731,11,15,.733,7,18,25,6,1,5,9,20,30
Ben Simmons,PG,24,36,36,1228,227,403,.563,3,8,.375,224,395,.567,.567,122,189,.646,65,223,288,272,54,25,126,111,579
Anfernee Simons,SG,21,36,0,597,97,246,.394,70,171,.409,27,75,.360,.537,24,30,.800,8,75,83,51,8,5,29,61,288
Deividas Sirvydis,SG,20,7,0,12,0,4,.000,0,4,.000,0,0,,.000,1,2,.500,0,2,2,1,1,0,0,1,1
Alen Smailagić,PF,20,3,1,13,2,7,.286,1,4,.250,1,3,.333,.357,0,2,.000,0,0,0,0,0,0,0,5,5
Marcus Smart,PG,26,25,22,786,101,259,.390,45,139,.324,56,120,.467,.477,71,90,.789,12,58,70,135,38,12,41,62,318
Dennis Smith Jr.,PG,23,19,7,349,51,128,.398,17,51,.333,34,77,.442,.465,12,16,.750,11,39,50,66,20,14,23,30,131
Ish Smith,PG,32,19,1,391,44,116,.379,5,20,.250,39,96,.406,.401,6,15,.400,10,56,66,90,15,4,19,18,99
Jalen Smith,PF,20,15,0,66,8,21,.381,2,9,.222,6,12,.500,.429,1,3,.333,5,10,15,2,0,2,3,7,19
Tony Snell,SG,29,31,14,613,60,119,.504,46,82,.561,14,37,.378,.697,2,2,1.000,13,58,71,42,5,8,14,45,168
Ray Spalding,C,23,2,0,19,2,4,.500,0,1,.000,2,3,.667,.500,0,2,.000,2,2,4,0,0,2,3,3,4
Cassius Stanley,SG,21,11,0,31,4,15,.267,1,5,.200,3,10,.300,.300,4,5,.800,4,4,8,0,0,2,1,8,13
Lamar Stevens,PF,23,29,0,389,48,112,.429,2,19,.105,46,93,.495,.438,30,42,.714,19,59,78,24,14,9,15,41,128
Isaiah Stewart,C,19,41,2,783,111,194,.572,6,14,.429,105,180,.583,.588,28,42,.667,94,149,243,31,23,42,37,98,256
Max Strus,SF,24,22,0,299,52,111,.468,34,91,.374,18,20,.900,.622,10,14,.714,3,19,22,11,4,0,3,26,148
Edmond Sumner,SG,25,30,5,358,59,116,.509,17,44,.386,42,72,.583,.582,26,33,.788,10,30,40,15,15,3,24,40,161
Jae'Sean Tate,SF,25,43,31,1212,177,340,.521,33,101,.327,144,239,.603,.569,58,83,.699,80,148,228,79,49,22,49,131,445
Jayson Tatum,SF,22,38,38,1351,344,773,.445,102,271,.376,242,502,.482,.511,151,176,.858,27,233,260,165,50,18,95,73,941
Jeff Teague,PG,32,34,5,616,78,188,.415,26,56,.464,52,132,.394,.484,51,61,.836,10,47,57,73,26,7,39,43,233
Garrett Temple,SG,34,35,12,977,110,259,.425,46,134,.343,64,125,.512,.514,31,38,.816,20,90,110,69,32,18,35,81,297
Tyrell Terry,PG,20,11,0,56,5,16,.313,0,7,.000,5,9,.556,.313,1,3,.333,0,6,6,6,5,0,2,2,11
Daniel Theis,C,28,42,37,1027,159,288,.552,33,95,.347,126,193,.653,.609,46,67,.687,54,166,220,67,25,43,41,120,397
Brodric Thomas,SG,24,9,0,63,10,23,.435,4,13,.308,6,10,.600,.522,7,9,.778,2,5,7,9,2,2,4,8,31
Matt Thomas,SG,26,26,0,192,24,62,.387,17,41,.415,7,21,.333,.524,6,7,.857,3,18,21,9,2,0,6,10,71
Tristan Thompson,PF,29,36,31,811,119,223,.534,0,3,.000,119,220,.541,.534,48,80,.600,113,189,302,36,13,13,35,75,286
Sindarius Thornwell,SG,26,14,1,73,7,21,.333,3,9,.333,4,12,.333,.405,0,2,.000,1,4,5,4,5,1,4,3,17
Matisse Thybulle,SG,23,41,5,768,58,141,.411,27,86,.314,31,55,.564,.507,8,14,.571,21,49,70,41,62,40,16,86,151
Killian Tillie,C,22,4,0,30,2,10,.200,2,5,.400,0,5,.000,.300,1,2,.500,3,2,5,1,1,3,1,5,7
Xavier Tillman Sr.,PF,22,32,7,612,90,172,.523,10,36,.278,80,136,.588,.552,20,27,.741,42,94,136,48,28,18,27,72,210
Obi Toppin,PF,22,34,0,405,58,123,.472,14,47,.298,44,76,.579,.528,11,15,.733,16,62,78,16,8,10,19,35,141
Juan Toscano-Anderson,SG,27,29,13,554,57,108,.528,18,45,.400,39,63,.619,.611,13,18,.722,18,101,119,66,18,15,31,59,145
Axel Toupane,G-F,28,1,0,3,0,1,.000,0,0,,0,1,.000,.000,0,0,,0,1,1,0,0,2,0,1,0
Karl-Anthony Towns,C,25,24,24,806,202,407,.496,54,138,.391,148,269,.550,.563,106,123,.862,61,179,240,99,20,36,79,84,564
Gary Trent Jr.,SG,22,41,23,1262,217,524,.414,121,305,.397,96,219,.438,.530,58,75,.773,21,70,91,58,37,6,31,63,613
P.J. Tucker,PF,35,35,32,1003,49,135,.363,28,90,.311,21,45,.467,.467,18,23,.783,36,118,154,46,29,20,33,93,144
Rayjon Tucker,F,23,1,0,3,0,0,,0,0,,0,0,,,4,4,1.000,0,0,0,1,0,0,0,2,4
Myles Turner,C,24,40,40,1234,179,373,.480,57,174,.328,122,199,.613,.556,98,125,.784,55,203,258,40,36,137,53,138,513
Jonas Valančiūnas,C,28,36,35,995,233,418,.557,11,35,.314,222,383,.580,.571,94,126,.746,139,306,445,62,22,24,67,107,571
Denzel Valentine,SG,27,39,3,719,108,287,.376,57,169,.337,51,118,.432,.476,9,9,1.000,17,133,150,65,25,1,22,42,282
Jarred Vanderbilt,PF,21,42,24,766,96,157,.611,1,2,.500,95,155,.613,.615,42,72,.583,70,165,235,58,43,30,43,87,235
Fred VanVleet,SG,26,39,39,1434,256,646,.396,131,348,.376,125,298,.419,.498,139,154,.903,25,142,167,248,69,29,76,96,782
Devin Vassell,SF,20,34,1,590,64,156,.410,33,80,.413,31,76,.408,.516,24,28,.857,17,89,106,37,32,10,15,50,185
Gabe Vincent,PG,24,29,5,418,61,158,.386,29,99,.293,32,59,.542,.478,19,21,.905,5,29,34,39,13,2,22,50,170
Noah Vonleh,PF,25,4,0,11,0,3,.000,0,2,.000,0,1,.000,.000,0,0,,0,1,1,1,0,0,2,2,0
Nikola Vučević,C,30,44,44,1500,436,908,.480,117,288,.406,319,620,.515,.545,91,110,.827,87,430,517,167,42,28,83,79,1080
Dean Wade,PF,24,36,5,468,54,124,.435,33,83,.398,21,41,.512,.569,12,17,.706,19,66,85,30,8,11,14,31,153
Moritz Wagner,C,23,25,13,375,62,122,.508,13,42,.310,49,80,.613,.561,41,52,.788,13,60,73,32,22,8,21,62,178
Kemba Walker,PG,30,26,26,798,159,403,.395,75,206,.364,84,197,.426,.488,72,78,.923,8,84,92,120,30,9,57,33,465
Lonnie Walker,SG,22,37,30,968,164,386,.425,63,177,.356,101,209,.483,.506,36,46,.783,9,94,103,61,19,13,38,73,427
John Wall,PG,30,29,29,922,216,522,.414,58,177,.328,158,345,.458,.469,120,161,.745,15,84,99,182,27,20,96,36,610
Brad Wanamaker,PG,31,39,0,625,61,173,.353,13,61,.213,48,112,.429,.390,50,56,.893,8,58,66,99,26,6,37,55,185
T.J. Warren,SF,27,4,4,117,27,51,.529,0,7,.000,27,44,.614,.529,8,10,.800,2,12,14,5,2,0,4,16,62
P.J. Washington,PF,22,39,39,1156,172,382,.450,55,139,.396,117,243,.481,.522,82,103,.796,58,198,256,112,38,49,87,106,481
Yuta Watanabe,SF,26,27,1,307,21,67,.313,13,35,.371,8,32,.250,.410,9,10,.900,20,61,81,13,10,14,8,25,64
Tremont Waters,PG,23,11,1,98,10,31,.323,6,15,.400,4,16,.250,.419,7,8,.875,2,6,8,30,6,0,13,6,33
Paul Watson,SF,26,24,0,234,25,55,.455,20,44,.455,5,11,.455,.636,2,4,.500,3,32,35,11,5,2,6,31,72
Quinndary Weatherspoon,SG,24,9,0,44,2,8,.250,0,2,.000,2,6,.333,.250,2,2,1.000,0,3,3,4,4,1,7,8,6
Russell Westbrook,PG,32,35,35,1214,288,658,.438,45,144,.313,243,514,.473,.472,140,228,.614,54,280,334,360,45,11,170,97,761
Coby White,PG,20,43,36,1362,238,582,.409,97,277,.350,141,305,.462,.492,76,85,.894,21,175,196,200,22,6,98,105,649
Derrick White,SG,26,17,13,453,72,186,.387,31,95,.326,41,91,.451,.470,42,48,.875,3,39,42,57,11,19,25,43,217
Hassan Whiteside,C,31,28,1,416,96,173,.555,0,1,.000,96,172,.558,.555,33,63,.524,49,120,169,16,6,39,32,52,225
Greg Whittington,PF,27,4,0,12,0,3,.000,0,2,.000,0,1,.000,.000,0,0,,0,0,0,0,0,0,0,0,0
Andrew Wiggins,PF,25,44,44,1417,293,625,.469,85,222,.383,208,403,.516,.537,107,154,.695,47,156,203,93,41,41,83,101,778
Grant Williams,PF,22,36,6,657,65,144,.451,31,74,.419,34,70,.486,.559,19,35,.543,34,74,108,34,19,13,30,91,180
Kenrich Williams,PF,26,44,6,861,131,226,.580,28,63,.444,103,163,.632,.642,20,37,.541,56,122,178,83,30,8,43,77,310
Lou Williams,PG,34,42,3,918,181,430,.421,45,119,.378,136,311,.437,.473,103,119,.866,15,73,88,144,39,4,66,42,510
Patrick Williams,PF,19,42,42,1193,155,332,.467,36,94,.383,119,238,.500,.521,59,77,.766,39,168,207,52,30,31,60,92,405
Robert Williams,C,23,37,0,636,127,174,.730,0,1,.000,127,173,.734,.730,31,50,.620,89,147,236,49,31,64,37,70,285
Zion Williamson,PF,20,41,41,1339,404,651,.621,7,20,.350,397,631,.629,.626,240,339,.708,109,179,288,141,36,28,104,96,1055
D.J. Wilson,PF,24,16,0,156,24,62,.387,13,36,.361,11,26,.423,.492,5,7,.714,5,34,39,4,1,5,5,20,66
Dylan Windler,SF,24,30,0,507,56,130,.431,26,78,.333,30,52,.577,.531,21,27,.778,20,86,106,33,18,12,29,36,159
Justise Winslow,SF,24,14,0,299,48,132,.364,5,37,.135,43,95,.453,.383,9,16,.563,13,58,71,26,9,7,22,30,110
Cassius Winston,PG,22,9,0,56,6,14,.429,5,10,.500,1,4,.250,.607,2,2,1.000,0,7,7,10,0,1,1,4,19
James Wiseman,C,19,30,18,630,148,285,.519,11,31,.355,137,254,.539,.539,47,77,.610,43,134,177,20,9,30,44,97,354
Christian Wood,C,25,22,22,678,186,338,.550,37,97,.381,149,241,.618,.605,61,91,.670,37,179,216,29,19,31,41,44,470
Robert Woodard,SF,21,7,0,21,6,12,.500,1,4,.250,5,8,.625,.542,3,8,.375,3,5,8,0,0,0,1,1,16
Delon Wright,SG,28,36,31,1052,136,293,.464,31,89,.348,105,204,.515,.517,71,90,.789,37,127,164,181,58,19,48,45,374
Thaddeus Young,PF,32,39,7,974,219,369,.593,6,23,.261,213,346,.616,.602,29,53,.547,96,155,251,168,53,24,80,98,473
Trae Young,PG,22,42,42,1445,324,750,.432,103,284,.363,221,466,.474,.501,332,380,.874,31,139,170,393,34,10,177,81,1083
Cody Zeller,C,28,24,20,534,89,178,.500,3,20,.150,86,158,.544,.508,39,57,.684,62,109,171,55,15,11,24,58,220
Ivica Zubac,C,23,45,6,934,150,223,.673,0,2,.000,150,221,.679,.673,88,107,.822,110,204,314,52,20,37,47,107,388
