Player,Position,Age,Games,GS,MP,FG,FGA,FG_PCT,FG3,FG3A,FG3_PCT,FG2,FG2A,FG2_PCT,EFG_PCT,FT,FTA,FT_PCT,ORB,DRB,TRB,AST,STL,BLK,TOV,PF,PTS
Precious Achiuwa,PF,21,47,2,593,101,178,.567,0,0,,101,178,.567,.567,47,94,.500,58,111,169,25,15,24,38,72,249
Jaylen Adams,PG,24,7,0,18,1,8,.125,0,2,.000,1,6,.167,.125,0,0,,0,3,3,2,0,0,0,1,2
Steven Adams,C,27,45,45,1268,156,250,.624,0,3,.000,156,247,.632,.624,47,105,.448,176,227,403,89,41,30,67,93,359
Bam Adebayo,C,23,44,44,1480,317,564,.562,2,8,.250,315,556,.567,.564,211,253,.834,105,316,421,235,38,52,118,97,847
LaMarcus Aldridge,C,35,23,20,600,124,268,.463,29,77,.377,95,191,.497,.517,33,39,.846,17,89,106,43,10,22,21,40,310
Ty-Shon Alexander,SG,22,5,0,15,1,5,.200,1,3,.333,0,2,.000,.300,1,2,.500,0,2,2,1,0,0,0,1,4
Nickeil Alexander-Walker,SG,22,41,10,851,158,378,.418,65,187,.348,93,191,.487,.504,39,52,.750,10,116,126,81,40,21,57,77,420
Grayson Allen,SG,25,34,22,824,112,265,.423,74,180,.411,38,85,.447,.562,47,52,.904,14,98,112,70,35,7,33,44,345
Jarrett Allen,C,22,44,26,1262,209,330,.633,5,12,.417,204,318,.642,.641,152,216,.704,134,302,436,74,20,74,65,70,575
Al-Farouq Aminu,PF,30,18,14,379,36,90,.400,7,32,.219,29,58,.500,.439,16,19,.842,20,76,96,29,17,9,27,24,95
Kyle Anderson,PF,27,45,45,1215,204,432,.472,59,166,.355,145,266,.545,.541,88,116,.759,31,229,260,151,52,35,60,71,555
Giannis Antetokounmpo,PF,26,45,45,1529,468,829,.565,51,169,.302,417,660,.632,.595,307,447,.687,80,432,512,277,51,60,169,129,1294
Kostas Antetokounmpo,PF,23,9,0,35,2,5,.400,0,0,,2,5,.400,.400,2,6,.333,2,10,12,0,2,3,8,3,6
Thanasis Antetokounmpo,SF,28,37,1,363,51,91,.560,7,20,.350,44,71,.620,.599,12,26,.462,36,48,84,28,14,7,29,48,121
Carmelo Anthony,PF,36,48,3,1233,234,564,.415,84,220,.382,150,344,.436,.489,104,120,.867,25,130,155,80,38,32,49,107,656
Cole Anthony,PG,20,25,17,667,101,269,.375,27,83,.325,74,186,.398,.426,46,55,.836,20,91,111,94,17,11,51,51,275
OG Anunoby,SF,23,31,31,1033,168,346,.486,73,180,.406,95,166,.572,.591,57,75,.760,47,138,185,58,53,25,54,85,466
Ryan Arcidiacono,PG,26,30,0,332,33,86,.384,16,50,.320,17,36,.472,.477,12,16,.750,3,43,46,42,7,0,7,35,94
Trevor Ariza,SF,35,9,6,221,22,65,.338,11,38,.289,11,27,.407,.423,9,13,.692,4,33,37,12,5,7,4,10,64
D.J. Augustin,PG,33,46,6,895,100,257,.389,61,163,.374,39,94,.415,.508,56,61,.918,16,59,75,146,25,1,52,44,317
Deni Avdija,SF,20,44,22,1010,107,254,.421,43,137,.314,64,117,.547,.506,20,32,.625,17,196,213,51,25,10,30,120,277
Deandre Ayton,C,22,48,48,1461,299,492,.608,4,17,.235,295,475,.621,.612,95,125,.760,157,361,518,71,19,53,79,144,697
Udoka Azubuike,C,21,12,0,49,4,7,.571,0,0,,4,7,.571,.571,4,6,.667,4,9,13,0,1,4,3,8,12
Dwayne Bacon,SG,25,50,32,1284,192,484,.397,48,153,.314,144,331,.435,.446,90,108,.833,16,134,150,62,27,4,34,83,522
Marvin Bagley III,PF,21,37,37,951,209,416,.502,34,96,.354,175,320,.547,.543,61,109,.560,91,184,275,35,18,19,49,90,513
LaMelo Ball,PG,19,41,21,1174,237,526,.451,81,216,.375,156,310,.503,.528,97,123,.789,54,186,240,251,65,14,115,116,652
Lonzo Ball,PG,23,39,39,1242,204,479,.426,122,311,.392,82,168,.488,.553,36,46,.783,23,139,162,220,53,21,82,81,566
Mo Bamba,C,22,28,0,323,65,138,.471,15,49,.306,50,89,.562,.525,14,24,.583,35,81,116,12,5,25,14,49,159
Desmond Bane,SG,22,43,11,970,152,318,.478,74,164,.451,78,154,.506,.594,28,33,.848,17,117,134,60,28,7,40,84,406
Harrison Barnes,PF,28,47,47,1688,248,507,.489,71,193,.368,177,314,.564,.559,165,199,.829,54,257,311,170,37,9,72,61,732
RJ Barrett,SG,20,50,50,1700,326,735,.444,61,175,.349,265,560,.473,.485,148,203,.729,54,243,297,154,37,13,98,130,861
Will Barton,SF,30,46,42,1432,215,501,.429,79,210,.376,136,291,.467,.508,65,87,.747,32,162,194,145,40,22,77,74,574
Keita Bates-Diop,SF,25,16,0,118,11,32,.344,5,15,.333,6,17,.353,.422,7,10,.700,5,15,20,7,6,1,1,5,34
Nicolas Batum,SF,32,48,38,1372,137,299,.458,86,203,.424,51,96,.531,.602,40,48,.833,40,196,236,117,55,18,38,78,400
Aron Baynes,C,34,46,31,850,109,258,.422,20,86,.233,89,172,.517,.461,26,36,.722,75,158,233,42,13,20,38,103,264
Kent Bazemore,SF,31,48,1,784,102,230,.443,42,111,.378,60,119,.504,.535,33,48,.688,17,121,138,72,40,23,53,103,279
Darius Bazley,PF,20,36,36,1104,158,403,.392,54,186,.290,104,217,.479,.459,57,81,.704,22,248,270,54,18,23,63,31,427
Bradley Beal,SG,27,41,41,1454,449,926,.485,90,266,.338,359,660,.544,.533,296,328,.902,46,160,206,196,49,15,137,102,1284
Malik Beasley,SG,24,37,36,1214,264,600,.440,128,321,.399,136,279,.487,.547,68,80,.850,28,134,162,88,30,7,60,62,724
Jordan Bell,C,26,3,1,50,5,15,.333,0,2,.000,5,13,.385,.333,0,0,,5,11,16,5,1,3,3,4,10
DeAndre' Bembry,SF,26,33,7,569,64,120,.533,9,28,.321,55,92,.598,.571,20,29,.690,19,62,81,64,23,10,36,52,157
Dāvis Bertāns,PF,28,36,4,884,116,297,.391,100,262,.382,16,35,.457,.559,58,68,.853,15,88,103,31,21,8,22,89,390
Patrick Beverley,PG,32,29,29,689,80,181,.442,50,119,.420,30,62,.484,.580,31,39,.795,27,80,107,60,25,23,27,91,241
Saddiq Bey,SF,21,47,30,1166,159,400,.398,104,275,.378,55,125,.440,.528,74,85,.871,25,165,190,62,29,5,35,82,496
Tyler Bey,SF,22,10,0,33,3,11,.273,0,1,.000,3,10,.300,.273,2,4,.500,5,7,12,1,0,1,0,4,8
Khem Birch,C,28,47,5,936,94,207,.454,4,21,.190,90,186,.484,.464,63,85,.741,116,125,241,52,31,28,23,64,255
Goga Bitadze,C,21,29,0,284,52,103,.505,8,33,.242,44,70,.629,.544,23,33,.697,34,46,80,11,5,28,11,50,135
Bismack Biyombo,C,28,47,28,1002,106,184,.576,0,1,.000,106,183,.579,.576,39,81,.481,95,150,245,62,13,54,49,111,251
Nemanja Bjelica,PF,32,30,1,491,76,166,.458,20,68,.294,56,98,.571,.518,33,45,.733,24,87,111,54,9,2,31,57,205
Eric Bledsoe,SG,31,48,47,1443,199,483,.412,87,241,.361,112,242,.463,.502,77,114,.675,20,143,163,186,35,16,77,80,562
Keljin Blevins,SF,25,10,0,51,2,14,.143,0,5,.000,2,9,.222,.143,0,0,,0,2,2,4,2,0,3,4,4
Bogdan Bogdanović,SG,28,25,8,637,111,253,.439,58,151,.384,53,102,.520,.553,19,21,.905,11,74,85,71,20,7,25,56,299
Bojan Bogdanović,SF,31,49,49,1471,237,571,.415,120,308,.390,117,263,.445,.520,131,150,.873,26,166,192,94,26,3,68,81,725
Bol Bol,PF,21,20,2,107,19,36,.528,9,18,.500,10,18,.556,.653,4,7,.571,0,16,16,6,2,6,9,11,51
Marques Bolden,C,22,6,0,29,1,3,.333,0,0,,1,3,.333,.333,5,8,.625,3,3,6,0,2,2,2,0,7
Jordan Bone,PG,23,14,0,196,23,54,.426,10,32,.313,13,22,.591,.519,0,0,,4,20,24,18,2,0,3,11,56
Isaac Bonga,SF,21,30,7,355,24,63,.381,11,37,.297,13,26,.500,.468,3,6,.500,17,42,59,19,8,7,16,52,62
Devin Booker,SG,24,44,44,1490,416,838,.496,91,256,.355,325,582,.558,.551,205,240,.854,15,164,179,199,38,11,143,124,1128
Chris Boucher,C,28,49,4,1136,228,433,.527,73,179,.408,155,254,.610,.611,120,155,.774,90,218,308,49,27,95,36,132,649
Brian Bowen,SF,22,3,0,8,1,2,.500,0,0,,1,2,.500,.500,1,1,1.000,0,1,1,0,0,0,0,1,3
Avery Bradley,SG,30,14,1,301,44,104,.423,20,57,.351,24,47,.511,.519,8,11,.727,3,24,27,24,9,1,13,33,116
Tony Bradley,C,23,24,8,368,65,96,.677,0,3,.000,65,93,.699,.677,15,20,.750,47,83,130,21,8,16,13,37,145
Jarrell Brantley,PF,24,16,0,55,10,23,.435,5,14,.357,5,9,.556,.543,2,2,1.000,3,10,13,4,3,1,1,9,27
Ignas Brazdeikis,SF,22,5,0,15,0,4,.000,0,1,.000,0,3,.000,.000,2,2,1.000,1,3,4,1,0,0,1,0,2
Mikal Bridges,SF,24,48,48,1554,238,450,.529,83,205,.405,155,245,.633,.621,77,94,.819,58,172,230,110,43,43,41,72,636
Miles Bridges,PF,22,49,3,1311,183,370,.495,64,167,.383,119,203,.586,.581,58,66,.879,63,219,282,97,31,35,76,104,488
Malcolm Brogdon,PG,28,44,44,1550,353,771,.458,118,293,.403,235,478,.492,.534,109,125,.872,36,173,209,258,45,10,94,85,933
Dillon Brooks,SF,25,44,44,1276,266,660,.403,80,243,.329,186,417,.446,.464,95,114,.833,36,94,130,105,55,17,85,151,707
Bruce Brown,PG,24,46,30,1001,161,292,.551,10,40,.250,151,252,.599,.568,59,78,.756,72,139,211,68,35,13,37,98,391
Jaylen Brown,SG,24,46,46,1552,422,872,.484,122,307,.397,300,565,.531,.554,152,201,.756,56,206,262,165,57,23,125,131,1118
Moses Brown,C,21,20,9,387,63,110,.573,0,0,,63,110,.573,.573,44,74,.595,63,105,168,4,11,22,15,37,170
Sterling Brown,SG,25,47,14,1152,135,310,.435,82,200,.410,53,110,.482,.568,24,26,.923,37,179,216,67,36,12,36,94,376
Troy Brown Jr.,SF,21,25,0,362,42,108,.389,17,53,.321,25,55,.455,.468,13,19,.684,15,56,71,23,6,4,17,36,114
Jalen Brunson,PG,24,44,10,1112,211,392,.538,52,132,.394,159,260,.612,.605,93,114,.816,14,141,155,148,25,0,60,74,567
Thomas Bryant,C,23,10,10,271,59,91,.648,9,21,.429,50,70,.714,.698,16,24,.667,18,43,61,15,4,8,11,31,143
Reggie Bullock,SF,29,43,42,1194,146,342,.427,92,230,.400,54,112,.482,.561,26,30,.867,11,135,146,58,32,8,31,95,410
Trey Burke,PG,28,47,0,682,115,257,.447,47,126,.373,68,131,.519,.539,34,40,.850,5,37,42,64,25,3,24,48,311
Alec Burks,SG,29,38,5,993,165,389,.424,77,187,.412,88,202,.436,.523,82,96,.854,19,146,165,84,29,11,39,77,489
Jimmy Butler,SF,31,35,35,1178,246,507,.485,14,68,.206,232,439,.528,.499,236,277,.852,71,192,263,256,69,13,76,51,742
Bruno Caboclo,PF,25,6,0,36,8,17,.471,0,5,.000,8,12,.667,.471,1,2,.500,3,11,14,1,0,2,4,6,17
Devontae Cacok,PF,24,12,1,54,10,17,.588,0,0,,10,17,.588,.588,3,7,.429,7,10,17,1,5,2,3,5,23
Kentavious Caldwell-Pope,SG,27,46,46,1221,129,314,.411,69,174,.397,60,140,.429,.521,58,69,.841,21,99,120,69,37,13,50,75,385
Facundo Campazzo,PG,29,43,1,769,63,171,.368,41,120,.342,22,51,.431,.488,34,42,.810,11,51,62,118,43,9,41,83,201
Vlatko Čančar,PF,23,25,0,148,14,33,.424,5,18,.278,9,15,.600,.500,5,6,.833,5,24,29,8,8,2,9,13,38
Clint Capela,C,26,44,44,1310,288,488,.590,0,0,,288,488,.590,.590,89,151,.589,211,414,625,35,33,100,55,103,665
Vernon Carey Jr.,C,19,9,0,30,2,6,.333,0,3,.000,2,3,.667,.333,1,2,.500,2,7,9,1,0,2,2,1,5
Jevon Carter,PG,25,36,0,360,38,100,.380,21,66,.318,17,34,.500,.485,2,2,1.000,5,40,45,43,15,7,7,37,99
Wendell Carter Jr.,C,21,37,27,930,157,299,.525,9,30,.300,148,269,.550,.540,100,134,.746,86,211,297,79,22,31,57,106,423
Michael Carter-Williams,SG,29,26,20,684,87,229,.380,11,47,.234,76,182,.418,.404,40,60,.667,34,86,120,115,17,14,59,72,225
Alex Caruso,PG,26,40,0,810,80,196,.408,36,90,.400,44,106,.415,.500,32,49,.653,22,97,119,97,45,10,45,71,228
Willie Cauley-Stein,C,27,35,11,599,79,127,.622,1,8,.125,78,119,.655,.626,33,50,.660,40,110,150,26,11,28,16,80,192
Chris Chiozza,PG,25,18,0,172,22,65,.338,11,33,.333,11,32,.344,.423,10,13,.769,3,14,17,50,6,4,12,14,65
Marquese Chriss,PF,23,2,0,27,5,14,.357,1,5,.200,4,9,.444,.393,2,4,.500,3,10,13,2,0,2,2,3,13
Gary Clark,SF,26,35,11,637,40,131,.305,31,108,.287,9,23,.391,.424,8,10,.800,33,79,112,30,12,7,17,34,119
Brandon Clarke,PF,24,41,16,1056,200,382,.524,19,60,.317,181,322,.562,.548,60,87,.690,61,164,225,70,44,35,24,63,479
Jordan Clarkson,SG,28,49,0,1249,308,729,.422,149,423,.352,159,306,.520,.525,83,87,.954,39,156,195,110,42,7,83,72,848
Nicolas Claxton,C,21,18,0,327,61,101,.604,1,4,.250,60,97,.619,.609,19,35,.543,27,58,85,16,11,24,11,33,142
Amir Coffey,SG,23,33,0,265,34,70,.486,19,43,.442,15,27,.556,.621,9,17,.529,6,21,27,15,7,0,11,13,96
John Collins,PF,23,47,47,1422,333,611,.545,60,158,.380,273,453,.603,.594,129,154,.838,98,267,365,65,25,49,57,152,855
Mike Conley,PG,33,39,39,1156,222,489,.454,106,256,.414,116,233,.498,.562,86,102,.843,29,107,136,214,54,6,77,72,636
Pat Connaughton,SG,28,46,2,1069,113,253,.447,66,169,.391,47,84,.560,.577,23,30,.767,45,175,220,62,32,17,21,72,315
Quinn Cook,PG,27,23,0,157,29,68,.426,11,26,.423,18,42,.429,.507,7,8,.875,2,15,17,18,4,1,7,10,76
Tyler Cook,SF-PF,23,13,0,128,13,24,.542,0,0,,13,24,.542,.542,4,9,.444,10,19,29,5,2,0,9,14,30
DeMarcus Cousins,C,30,25,11,506,79,210,.376,39,116,.336,40,94,.426,.469,44,59,.746,30,161,191,60,21,18,39,74,241
Robert Covington,PF,30,47,47,1513,148,356,.416,101,255,.396,47,101,.465,.558,32,39,.821,37,282,319,78,76,59,52,129,429
Torrey Craig,SF,30,26,0,335,41,90,.456,14,37,.378,27,53,.509,.533,3,6,.500,24,52,76,24,16,9,9,40,99
Jae Crowder,PF,30,45,30,1250,153,376,.407,110,285,.386,43,91,.473,.553,45,56,.804,21,201,222,94,38,19,42,84,461
Jarrett Culver,SG,21,27,7,439,62,151,.411,10,44,.227,52,107,.486,.444,27,44,.614,32,65,97,17,16,8,25,50,161
Seth Curry,SG,30,39,39,1136,178,391,.455,81,192,.422,97,199,.487,.559,59,66,.894,7,76,83,111,33,8,53,64,496
Stephen Curry,PG,32,42,42,1419,407,855,.476,196,483,.406,211,372,.567,.591,225,243,.926,22,207,229,254,56,4,132,74,1235
Nate Darling,SG,22,4,0,16,2,6,.333,2,6,.333,0,0,,.500,0,0,,1,0,1,1,0,0,0,0,6
Anthony Davis,PF,27,23,23,755,204,383,.533,17,58,.293,187,325,.575,.555,93,130,.715,47,146,193,70,31,41,45,42,518
Ed Davis,C,31,19,7,264,18,43,.419,0,0,,18,43,.419,.419,7,8,.875,38,59,97,19,10,10,6,49,43
Terence Davis,SG,23,39,4,595,109,254,.429,57,153,.373,52,101,.515,.541,20,23,.870,10,71,81,45,22,9,36,56,295
Matthew Dellavedova,PG,30,2,0,33,1,7,.143,1,2,.500,0,5,.000,.214,0,0,,2,1,3,10,0,0,0,2,3
DeMar DeRozan,PF,31,40,40,1368,292,591,.494,18,61,.295,274,530,.517,.509,240,273,.879,26,150,176,287,38,11,75,79,842
Mamadi Diakite,PF,24,6,0,56,8,18,.444,1,4,.250,7,14,.500,.472,0,0,,5,10,15,4,0,4,1,7,17
Hamidou Diallo,SG-SF,22,36,5,858,163,331,.492,17,50,.340,146,281,.520,.518,96,146,.658,41,146,187,84,33,15,54,93,439
Gorgui Dieng,C,31,23,1,377,56,108,.519,23,48,.479,33,60,.550,.625,39,45,.867,28,70,98,29,17,14,22,38,174
Spencer Dinwiddie,SG,27,3,3,64,6,16,.375,2,7,.286,4,9,.444,.438,6,6,1.000,0,13,13,9,2,1,5,4,20
Donte DiVincenzo,SG,24,48,48,1319,188,449,.419,94,245,.384,94,204,.461,.523,37,52,.712,61,206,267,147,55,9,68,78,507
Luka Dončić,PG,21,43,43,1503,437,896,.488,129,348,.371,308,548,.562,.560,226,309,.731,32,317,349,378,43,26,186,93,1229
Luguentz Dort,SG,21,41,41,1203,177,459,.386,80,245,.327,97,214,.453,.473,81,106,.764,27,114,141,64,35,15,58,99,515
Damyean Dotson,SG,26,35,6,658,87,221,.394,32,115,.278,55,106,.519,.466,22,32,.688,5,65,70,74,14,4,28,31,228
Devon Dotson,PG,21,3,0,15,2,4,.500,0,0,,2,4,.500,.500,0,0,,1,1,2,0,1,0,0,1,4
Sekou Doumbouya,PF,20,40,2,503,53,156,.340,17,70,.243,36,86,.419,.394,22,30,.733,18,65,83,23,15,2,26,55,145
PJ Dozier,SG,24,34,0,674,85,205,.415,30,86,.349,55,119,.462,.488,29,46,.630,23,100,123,53,17,16,28,61,229
Goran Dragić,PG,34,31,10,832,151,341,.443,50,142,.352,101,199,.508,.516,65,77,.844,9,93,102,144,17,6,82,71,417
Andre Drummond,C,27,26,26,736,182,386,.472,0,8,.000,182,378,.481,.472,77,131,.588,101,237,338,66,40,30,84,73,441
Jared Dudley,PF,35,11,0,76,2,7,.286,2,5,.400,0,2,.000,.429,0,0,,4,15,19,5,1,1,2,7,6
Kevin Durant,PF,32,19,18,679,188,359,.524,49,113,.434,139,246,.565,.592,126,145,.869,7,132,139,100,14,27,67,43,551
Anthony Edwards,SG,19,50,33,1544,326,825,.395,106,338,.314,220,487,.452,.459,122,156,.782,41,173,214,127,52,23,103,86,880
Carsen Edwards,SG,22,20,1,191,38,82,.463,13,43,.302,25,39,.641,.543,7,9,.778,2,17,19,9,5,1,3,21,96
CJ Elleby,SF,20,17,0,138,17,46,.370,5,26,.192,12,20,.600,.424,7,11,.636,8,14,22,3,6,3,3,19,46
Henry Ellenson,PF,24,2,0,38,5,14,.357,2,9,.222,3,5,.600,.429,3,4,.750,3,9,12,5,0,0,0,7,15
Wayne Ellington,SG,33,36,28,820,126,281,.448,95,224,.424,31,57,.544,.617,24,31,.774,9,59,68,51,15,8,26,51,371
Joel Embiid,C,26,32,32,1039,299,572,.523,38,94,.404,261,478,.546,.556,316,371,.852,71,292,363,103,37,46,103,80,952
James Ennis,SF,30,33,29,784,94,191,.492,36,80,.450,58,111,.523,.586,50,62,.806,38,94,132,50,29,6,30,68,274
Drew Eubanks,C,23,29,0,376,51,100,.510,1,1,1.000,50,99,.505,.515,32,45,.711,21,80,101,24,6,28,24,41,135
Dante Exum,SG,25,6,3,116,10,26,.385,2,11,.182,8,15,.533,.423,1,2,.500,2,15,17,13,4,2,7,9,23
Tacko Fall,C,25,14,0,91,17,23,.739,0,0,,17,23,.739,.739,4,13,.308,11,26,37,2,0,12,4,15,38
Derrick Favors,C,29,47,0,735,113,179,.631,0,1,.000,113,178,.635,.631,51,69,.739,97,160,257,37,25,47,27,106,277
Cristiano Felício,C,28,9,0,43,3,4,.750,0,0,,3,4,.750,.750,6,10,.600,6,7,13,5,2,0,3,3,12
Terrance Ferguson,SG,22,13,0,49,1,7,.143,0,5,.000,1,2,.500,.143,0,0,,0,1,1,2,1,0,4,7,2
Bruno Fernando,C,22,24,0,171,12,28,.429,0,2,.000,12,26,.462,.429,10,16,.625,13,51,64,9,2,3,17,19,34
Yogi Ferrell,PG,27,2,0,40,8,21,.381,3,9,.333,5,12,.417,.452,0,2,.000,3,4,7,5,3,1,3,4,19
Dorian Finney-Smith,PF,27,37,37,1172,116,265,.438,62,171,.363,54,94,.574,.555,21,25,.840,58,137,195,55,32,13,23,92,315
Malachi Flynn,PG,22,24,0,268,27,85,.318,8,44,.182,19,41,.463,.365,6,9,.667,1,25,26,35,9,0,10,21,68
Bryn Forbes,SG,27,48,6,914,160,353,.453,103,228,.452,57,125,.456,.599,26,34,.765,8,54,62,28,13,0,27,53,449
Trent Forrest,PG,22,13,0,72,7,15,.467,0,3,.000,7,12,.583,.467,2,2,1.000,0,7,7,16,4,0,5,5,16
Evan Fournier,SF-SG,28,30,26,902,186,407,.457,84,211,.398,102,196,.520,.560,101,127,.795,5,77,82,102,32,12,58,65,557
De'Aaron Fox,PG,23,49,49,1700,438,918,.477,88,272,.324,350,646,.542,.525,236,333,.709,26,133,159,348,67,25,150,144,1200
Tim Frazier,PG,30,3,0,33,2,8,.250,0,2,.000,2,6,.333,.250,0,0,,0,4,4,7,1,0,3,4,4
Markelle Fultz,PG,22,8,8,215,41,104,.394,4,16,.250,37,88,.420,.413,17,19,.895,5,20,25,43,8,2,18,18,103
Wenyen Gabriel,PF,23,7,0,31,0,5,.000,0,1,.000,0,4,.000,.000,1,2,.500,4,6,10,5,0,0,4,2,1
Daniel Gafford,PF-C,22,33,11,411,70,100,.700,0,0,,70,100,.700,.700,31,46,.674,49,65,114,17,12,39,25,56,171
Danilo Gallinari,PF,32,37,4,883,146,342,.427,76,191,.398,70,151,.464,.538,120,129,.930,9,142,151,54,20,7,36,75,488
Langston Galloway,SG,29,34,0,377,57,121,.471,32,71,.451,25,50,.500,.603,17,17,1.000,5,30,35,24,6,0,11,23,163
Darius Garland,PG,21,40,37,1334,251,571,.440,69,175,.394,182,396,.460,.500,78,93,.839,20,76,96,233,46,3,124,91,649
Marc Gasol,C,36,41,40,805,66,160,.413,37,101,.366,29,59,.492,.528,33,42,.786,28,136,164,84,22,49,45,94,202
Rudy Gay,PF,34,40,0,873,164,398,.412,67,171,.392,97,227,.427,.496,54,69,.783,34,166,200,63,31,24,41,74,449
Paul George,SF,30,38,38,1268,298,636,.469,119,281,.423,179,355,.504,.562,127,144,.882,33,207,240,205,43,17,121,88,842
Taj Gibson,PF,35,23,1,457,46,76,.605,3,14,.214,43,62,.694,.625,19,31,.613,41,73,114,15,14,21,13,45,114
Harry Giles,C,22,26,0,293,31,71,.437,6,13,.462,25,58,.431,.479,14,20,.700,28,89,117,22,6,10,18,48,82
Shai Gilgeous-Alexander,SG,22,35,35,1180,287,565,.508,71,170,.418,216,395,.547,.571,185,229,.808,19,147,166,207,27,23,106,70,830
Anthony Gill,PF,28,14,1,75,4,13,.308,1,9,.111,3,4,.750,.346,3,4,.750,3,16,19,4,3,2,3,4,12
Rudy Gobert,C,28,49,49,1503,269,413,.651,0,3,.000,269,410,.656,.651,177,288,.615,165,481,646,62,24,144,78,116,715
Brandon Goodwin,PG,25,32,1,355,48,132,.364,20,65,.308,28,67,.418,.439,17,24,.708,5,28,33,52,12,0,19,27,133
Aaron Gordon,PF,25,29,29,855,153,332,.461,45,121,.372,108,211,.512,.529,70,114,.614,43,142,185,115,21,24,71,53,421
Eric Gordon,SG,32,27,13,789,159,367,.433,69,210,.329,90,157,.573,.527,94,114,.825,8,50,58,71,14,13,51,44,481
Devonte' Graham,PG,25,39,33,1161,168,451,.373,115,309,.372,53,142,.373,.500,88,106,.830,17,90,107,198,40,3,58,53,539
Jerami Grant,SF,26,46,46,1598,339,799,.424,103,292,.353,236,507,.465,.489,249,291,.856,31,190,221,129,32,52,91,109,1030
Danny Green,SF,33,50,50,1420,166,402,.413,129,317,.407,37,85,.435,.573,21,29,.724,41,143,184,84,65,44,54,91,482
Draymond Green,PF,30,42,42,1273,102,245,.416,23,84,.274,79,161,.491,.463,44,57,.772,37,236,273,356,64,31,120,131,271
JaMychal Green,PF,30,37,4,687,112,243,.461,52,129,.403,60,114,.526,.568,34,41,.829,56,138,194,31,19,13,37,95,310
Javonte Green,SG-PG,27,27,2,368,40,76,.526,7,23,.304,33,53,.623,.572,20,30,.667,22,36,58,12,20,4,16,35,107
Jeff Green,C,34,46,23,1227,164,332,.494,67,158,.424,97,174,.557,.595,66,87,.759,23,150,173,63,27,16,35,80,461
Josh Green,SG,20,25,5,276,25,56,.446,2,16,.125,23,40,.575,.464,9,15,.600,16,34,50,14,7,2,14,19,61
Blake Griffin,PF,31,26,21,743,100,254,.394,45,137,.328,55,117,.470,.482,53,75,.707,11,123,134,90,19,4,38,56,298
Kyle Guy,PG,23,21,0,148,21,56,.375,10,31,.323,11,25,.440,.464,10,12,.833,3,19,22,19,4,0,4,14,62
Rui Hachimura,PF,22,40,40,1269,218,455,.479,35,104,.337,183,351,.521,.518,98,127,.772,34,199,233,64,30,3,49,86,569
Ashton Hagans,PG,21,2,0,4,0,0,,0,0,,0,0,,,0,0,,0,0,0,0,0,0,1,0,0
Tyrese Haliburton,PG,20,44,13,1329,224,464,.483,97,230,.422,127,234,.543,.587,34,39,.872,35,111,146,221,54,24,66,61,579
Josh Hall,SF,20,12,0,148,9,39,.231,2,17,.118,7,22,.318,.256,15,27,.556,1,22,23,17,0,0,14,18,35
R.J. Hampton,PG-SG,19,30,1,345,46,106,.434,8,29,.276,38,77,.494,.472,15,22,.682,14,58,72,22,10,3,17,28,115
Tim Hardaway Jr.,SG,28,47,20,1364,276,617,.447,140,354,.395,136,263,.517,.561,86,110,.782,14,147,161,80,25,6,41,74,778
James Harden,PG-SG,31,41,41,1554,334,721,.463,117,326,.359,217,395,.549,.544,275,316,.870,35,300,335,454,50,29,173,95,1060
Maurice Harkless,SF-PF,27,16,3,205,12,32,.375,8,23,.348,4,9,.444,.500,4,6,.667,3,18,21,12,4,4,6,24,36
Jared Harper,PG,23,4,0,9,0,2,.000,0,0,,0,2,.000,.000,2,2,1.000,0,0,0,0,0,0,2,0,2
Montrezl Harrell,C,27,50,1,1259,307,488,.629,0,10,.000,307,478,.642,.629,142,200,.710,129,212,341,54,35,39,57,100,756
Gary Harris,SG,26,19,19,581,69,156,.442,24,75,.320,45,81,.556,.519,22,30,.733,13,34,47,32,17,4,14,37,184
Jalen Harris,SG,22,4,0,14,1,4,.250,1,2,.500,0,2,.000,.375,0,0,,1,2,3,2,1,0,1,2,3
Joe Harris,SF,29,50,46,1547,258,509,.507,162,336,.482,96,173,.555,.666,32,44,.727,28,150,178,89,29,10,38,107,710
Tobias Harris,PF,28,45,45,1501,363,692,.525,65,162,.401,298,530,.562,.572,143,159,.899,47,282,329,163,40,38,86,92,934
Shaquille Harrison,SG,27,17,0,56,6,20,.300,0,2,.000,6,18,.333,.300,5,6,.833,3,6,9,9,2,0,5,3,17
Josh Hart,SF,25,47,4,1349,151,344,.439,63,193,.326,88,151,.583,.531,69,89,.775,53,324,377,109,38,12,49,111,434
Isaiah Hartenstein,C,22,33,1,335,50,100,.500,2,4,.500,48,96,.500,.510,28,48,.583,43,66,109,23,11,24,23,70,130
Jaxson Hayes,C,20,37,3,527,84,127,.661,1,2,.500,83,125,.664,.665,47,59,.797,42,89,131,22,13,19,23,69,216
Killian Hayes,PG,19,8,7,168,13,50,.260,5,21,.238,8,29,.276,.310,1,2,.500,1,12,13,28,2,0,18,17,32
Gordon Hayward,SF,30,44,44,1496,311,658,.473,85,205,.415,226,453,.499,.537,156,185,.843,37,221,258,181,52,14,91,74,863
Juan Hernangómez,PF,25,31,6,508,70,163,.429,28,89,.315,42,74,.568,.515,31,48,.646,27,102,129,18,12,2,14,29,199
Willy Hernangómez,C,26,27,2,443,76,141,.539,1,8,.125,75,133,.564,.543,27,46,.587,65,110,175,30,9,12,15,32,180
Tyler Herro,SG,21,39,14,1241,225,533,.422,72,223,.323,153,310,.494,.490,83,100,.830,20,181,201,134,26,15,79,54,605
Buddy Hield,SG,28,50,50,1732,282,710,.397,198,517,.383,84,193,.435,.537,63,74,.851,21,204,225,159,40,17,86,128,825
George Hill,PG,34,14,14,369,61,120,.508,22,57,.386,39,63,.619,.600,21,25,.840,8,21,29,43,12,2,12,12,165
Solomon Hill,PF,29,49,4,944,72,196,.367,49,149,.329,23,47,.489,.492,20,27,.741,27,89,116,44,32,8,29,75,213
Nate Hinton,SG,21,11,0,41,7,19,.368,1,6,.167,6,13,.462,.395,4,6,.667,0,3,3,4,4,1,4,2,19
Aaron Holiday,PG,24,46,6,798,120,310,.387,45,132,.341,75,178,.421,.460,35,47,.745,8,49,57,79,29,6,36,74,320
Jrue Holiday,PG,30,38,35,1203,257,505,.509,71,182,.390,186,323,.576,.579,62,76,.816,47,127,174,207,69,20,75,63,647
Justin Holiday,SG,31,48,39,1524,183,438,.418,122,318,.384,61,120,.508,.557,52,65,.800,26,154,180,80,63,17,42,97,540
Richaun Holmes,C,27,46,46,1389,277,430,.644,2,8,.250,275,422,.652,.647,99,123,.805,123,295,418,78,30,76,57,169,655
Rodney Hood,SF,28,42,5,797,80,217,.369,28,94,.298,52,123,.423,.433,14,17,.824,19,58,77,47,21,5,33,65,202
Al Horford,C,34,28,28,782,162,360,.450,56,152,.368,106,208,.510,.528,18,22,.818,29,159,188,94,25,26,29,48,398
Talen Horton-Tucker,SG,20,46,1,868,148,331,.447,21,86,.244,127,245,.518,.479,60,72,.833,19,103,122,101,40,20,64,94,377
Danuel House,SF,27,31,21,843,99,244,.406,50,139,.360,49,105,.467,.508,39,59,.661,18,103,121,59,19,14,30,61,287
Dwight Howard,C,35,50,5,876,129,221,.584,4,14,.286,125,207,.604,.593,88,155,.568,131,282,413,39,22,47,87,151,350
Markus Howard,SG,21,22,0,76,9,41,.220,5,29,.172,4,12,.333,.280,1,2,.500,0,7,7,8,2,0,6,11,24
Kevin Huerter,SG,22,50,35,1540,218,522,.418,103,285,.361,115,237,.485,.516,40,49,.816,31,135,166,173,60,11,62,119,579
Elijah Hughes,SF,22,10,0,38,7,18,.389,5,13,.385,2,5,.400,.528,3,4,.750,0,6,6,4,1,1,5,0,22
De'Andre Hunter,SF,23,20,18,625,112,223,.502,31,87,.356,81,136,.596,.572,65,75,.867,16,86,102,42,18,10,27,53,320
Chandler Hutchison,SF,24,11,0,150,16,45,.356,3,10,.300,13,35,.371,.389,6,7,.857,4,35,39,7,3,0,13,15,41
Serge Ibaka,C,31,39,39,919,176,347,.507,38,108,.352,138,239,.577,.562,37,45,.822,68,193,261,68,9,46,44,74,427
Andre Iguodala,SF,37,45,2,960,70,184,.380,46,138,.333,24,46,.522,.505,21,33,.636,30,145,175,95,45,21,47,61,207
Ersan İlyasova,PF,33,5,0,30,3,11,.273,2,9,.222,1,2,.500,.364,3,3,1.000,3,4,7,2,1,0,1,6,11
Joe Ingles,SF,33,45,13,1192,184,342,.538,123,246,.500,61,96,.635,.718,48,55,.873,19,147,166,186,32,9,70,80,539
Brandon Ingram,SF,23,46,46,1583,391,824,.475,110,285,.386,281,539,.521,.541,205,234,.876,27,199,226,218,29,32,110,92,1097
Kyrie Irving,PG,28,35,35,1249,376,733,.513,95,243,.391,281,490,.573,.578,121,135,.896,41,135,176,215,44,21,81,95,968
Wesley Iwundu,SF,26,27,3,361,24,70,.343,4,29,.138,20,41,.488,.371,17,19,.895,8,47,55,14,12,3,11,33,69
Frank Jackson,PG,22,20,4,276,43,101,.426,23,54,.426,20,47,.426,.540,19,23,.826,7,26,33,15,5,0,18,22,128
Josh Jackson,SG,23,44,9,1078,205,490,.418,50,178,.281,155,312,.497,.469,103,144,.715,41,137,178,94,41,33,93,126,563
Justin Jackson,SF,25,33,3,544,86,212,.406,34,111,.306,52,101,.515,.486,30,35,.857,14,57,71,51,15,2,31,31,236
Reggie Jackson,SG,30,48,28,1030,168,376,.447,72,176,.409,96,200,.480,.543,44,56,.786,16,111,127,140,28,4,53,91,452
Justin James,SF,24,25,0,151,18,42,.429,5,17,.294,13,25,.520,.488,5,12,.417,3,8,11,15,3,1,6,10,46
LeBron James,PG,36,41,41,1388,388,756,.513,98,266,.368,290,490,.592,.578,168,239,.703,24,299,323,323,43,24,152,65,1042
DaQuan Jeffries,SG,23,18,2,232,24,57,.421,9,28,.321,15,29,.517,.500,6,7,.857,9,20,29,6,7,4,8,23,63
Ty Jerome,SG,23,16,1,409,55,128,.430,34,80,.425,21,48,.438,.563,6,11,.545,10,39,49,56,12,2,16,32,150
Isaiah Joe,SG,21,26,1,272,32,91,.352,25,71,.352,7,20,.350,.489,8,9,.889,6,20,26,17,7,4,5,26,97
Alize Johnson,PF,24,3,0,38,12,16,.750,0,1,.000,12,15,.800,.750,1,1,1.000,6,14,20,3,2,0,1,1,25
Cameron Johnson,PF,24,42,9,970,145,329,.441,86,226,.381,59,103,.573,.571,34,39,.872,21,112,133,57,24,14,29,56,410
James Johnson,PF,33,32,4,595,86,181,.475,22,74,.297,64,107,.598,.536,23,40,.575,16,84,100,61,28,30,33,68,217
Keldon Johnson,SF,21,44,42,1270,220,465,.473,40,119,.336,180,346,.520,.516,101,131,.771,70,213,283,80,24,23,48,93,581
Stanley Johnson,PF,24,43,6,616,45,117,.385,26,72,.361,19,45,.422,.496,14,18,.778,20,80,100,52,28,12,29,77,130
Tyler Johnson,SG,28,31,2,522,56,142,.394,38,101,.376,18,41,.439,.528,16,19,.842,5,54,59,29,12,0,13,31,166
Nikola Jokić,C,25,49,49,1748,508,898,.566,73,171,.427,435,727,.598,.606,202,234,.863,140,397,537,421,74,31,151,133,1291
Damian Jones,C,25,22,6,206,24,33,.727,0,1,.000,24,32,.750,.727,17,23,.739,15,29,44,5,2,12,11,41,65
Derrick Jones Jr.,SF,23,44,40,1130,128,264,.485,39,119,.328,89,145,.614,.559,51,77,.662,71,115,186,38,33,48,27,106,346
Mason Jones,SG,22,27,1,316,50,117,.427,23,64,.359,27,53,.509,.526,35,57,.614,6,47,53,40,6,1,28,22,158
Tre Jones,PG,21,22,0,93,16,33,.485,1,1,1.000,15,32,.469,.500,5,5,1.000,5,4,9,10,2,0,7,5,38
Tyus Jones,PG,24,47,8,922,136,316,.430,31,105,.295,105,211,.498,.479,25,28,.893,17,91,108,194,51,5,38,21,328
DeAndre Jordan,C,32,46,36,1022,156,203,.768,0,1,.000,156,202,.772,.768,32,65,.492,92,239,331,75,14,56,69,97,344
Cory Joseph,PG,29,50,2,1085,133,295,.451,33,101,.327,100,194,.515,.507,55,67,.821,29,87,116,137,49,11,57,110,354
Mfiondu Kabengele,PF,23,23,0,94,9,32,.281,4,18,.222,5,14,.357,.344,5,6,.833,1,13,14,5,2,3,6,18,27
Frank Kaminsky,C,27,32,13,483,82,174,.471,26,64,.406,56,110,.509,.546,20,33,.606,22,96,118,52,10,13,15,42,210
Enes Kanter,C,28,49,32,1297,248,412,.602,0,1,.000,248,411,.603,.602,91,116,.784,209,361,570,62,26,35,58,126,587
Luke Kennard,SG,24,45,9,884,141,290,.486,75,159,.472,66,131,.504,.616,16,19,.842,12,110,122,77,14,8,35,69,373
Maxi Kleber,PF,29,35,29,977,86,196,.439,64,148,.432,22,48,.458,.602,32,35,.914,31,162,193,48,18,27,19,81,268
Nathan Knight,PF,23,20,0,147,21,49,.429,5,16,.313,16,33,.485,.480,26,32,.813,16,21,37,4,5,6,11,13,73
Kevin Knox,SF,21,33,0,433,54,133,.406,34,83,.410,20,50,.400,.534,13,16,.813,9,45,54,18,9,6,16,36,155
John Konchar,SG,24,24,0,334,31,71,.437,9,25,.360,22,46,.478,.500,17,20,.850,22,51,73,24,19,5,10,27,88
Furkan Korkmaz,SG,23,39,5,741,113,291,.388,63,175,.360,50,116,.431,.497,46,62,.742,10,68,78,47,30,7,34,45,335
Luke Kornet,PF-C,25,18,0,164,19,49,.388,10,35,.286,9,14,.643,.490,2,5,.400,6,27,33,9,2,11,3,7,50
Rodions Kurucs,SF-PF,22,16,0,91,6,24,.250,3,17,.176,3,7,.429,.313,1,2,.500,2,12,14,6,6,4,9,8,16
Kyle Kuzma,SF,25,49,19,1366,241,549,.439,97,271,.358,144,278,.518,.527,42,66,.636,90,244,334,82,22,26,85,84,621
Anthony Lamb,SF,23,9,0,119,7,34,.206,3,20,.150,4,14,.286,.250,3,4,.750,13,15,28,3,1,1,3,14,20
Jeremy Lamb,SG,28,28,8,602,96,216,.444,42,101,.416,54,115,.470,.542,58,61,.951,20,77,97,46,22,14,17,56,292
Romeo Langford,SG,21,1,0,12,1,4,.250,1,2,.500,0,2,.000,.375,0,0,,1,0,1,1,1,1,1,0,3
Zach LaVine,SG,25,47,47,1644,460,901,.511,157,373,.421,303,528,.574,.598,209,245,.853,29,203,232,223,39,20,173,113,1286
Jake Layman,SF,26,36,10,557,78,158,.494,19,66,.288,59,92,.641,.554,23,32,.719,13,48,61,26,26,16,23,38,198
Jalen Lecque,PG,20,4,0,12,1,9,.111,0,1,.000,1,8,.125,.111,3,3,1.000,2,3,5,2,0,0,0,0,5
Damion Lee,SG,28,49,1,927,107,236,.453,67,172,.390,40,64,.625,.595,36,40,.900,18,134,152,67,28,6,23,77,317
Saben Lee,PG,21,28,5,438,59,123,.480,7,13,.538,52,110,.473,.508,42,64,.656,13,39,52,84,17,8,27,43,167
Alex Len,C,27,40,18,609,104,164,.634,6,21,.286,98,143,.685,.652,43,73,.589,37,108,145,35,12,44,34,81,257
Kawhi Leonard,SF,29,42,42,1452,394,767,.514,81,206,.393,313,561,.558,.566,212,242,.876,50,224,274,207,76,19,80,70,1081
Meyers Leonard,C,28,3,2,29,3,7,.429,3,7,.429,0,0,,.643,1,2,.500,0,7,7,2,0,0,2,5,10
Caris LeVert,SG,26,24,16,728,157,378,.415,43,132,.326,114,246,.463,.472,56,72,.778,17,84,101,127,35,7,50,40,413
Kira Lewis Jr.,PG,19,33,0,519,87,206,.422,26,71,.366,61,135,.452,.485,21,28,.750,7,33,40,75,22,6,17,49,221
Damian Lillard,PG,30,47,47,1687,429,958,.448,196,513,.382,233,445,.524,.550,337,360,.936,24,176,200,363,45,12,150,74,1391
Nassir Little,PF,20,30,2,428,53,114,.465,24,62,.387,29,52,.558,.570,31,36,.861,22,60,82,15,4,11,13,33,161
Kevon Looney,C,24,39,15,599,61,105,.581,4,10,.400,57,95,.600,.600,20,27,.741,62,93,155,71,15,16,22,76,146
Brook Lopez,C,32,49,49,1331,206,428,.481,72,212,.340,134,216,.620,.565,74,88,.841,71,174,245,36,31,70,46,101,558
Robin Lopez,C,32,48,9,980,169,278,.608,5,17,.294,164,261,.628,.617,71,100,.710,105,97,202,41,14,32,52,85,414
Kevin Love,PF,32,6,6,101,14,41,.341,9,26,.346,5,15,.333,.451,9,11,.818,3,24,27,11,1,1,9,6,46
Kyle Lowry,PG,34,39,39,1348,220,505,.436,106,269,.394,114,236,.483,.541,118,134,.881,33,179,212,284,40,10,111,123,664
Timothé Luwawu-Cabarrot,SF,25,43,7,816,99,269,.368,60,180,.333,39,89,.438,.480,25,32,.781,19,83,102,55,28,5,34,80,283
Trey Lyles,PF,25,23,9,358,43,90,.478,14,40,.350,29,50,.580,.556,15,23,.652,9,77,86,14,6,1,6,13,115
Will Magnay,C,22,1,0,3,0,1,.000,0,1,.000,0,0,,.000,0,0,,0,0,0,0,0,0,1,1,0
Thon Maker,C,23,8,0,76,10,18,.556,0,2,.000,10,16,.625,.556,10,11,.909,8,10,18,4,2,4,3,7,30
Théo Maledon,PG,19,43,27,1165,137,367,.373,74,200,.370,63,167,.377,.474,50,64,.781,16,130,146,144,40,4,86,95,398
Karim Mané,PG,20,9,0,84,2,12,.167,1,2,.500,1,10,.100,.208,4,4,1.000,1,13,14,4,0,2,3,9,9
Terance Mann,SG,24,48,4,867,117,238,.492,22,57,.386,95,181,.525,.538,51,66,.773,45,141,186,70,19,10,31,90,307
Nico Mannion,PG,19,19,1,275,31,89,.348,18,48,.375,13,41,.317,.449,20,25,.800,2,28,30,51,13,1,23,24,100
Boban Marjanović,C,32,23,3,209,49,101,.485,0,6,.000,49,95,.516,.485,18,24,.750,39,62,101,7,1,4,9,22,116
Lauri Markkanen,PF,23,28,25,819,165,346,.477,70,185,.378,95,161,.590,.578,59,70,.843,21,141,162,26,13,11,34,46,459
Naji Marshall,SF,23,9,1,77,7,20,.350,2,7,.286,5,13,.385,.400,8,11,.727,1,10,11,8,3,2,4,8,24
Caleb Martin,SF,25,35,1,478,62,159,.390,21,70,.300,41,89,.461,.456,22,37,.595,20,65,85,35,27,7,22,34,167
Cody Martin,SF,25,37,2,528,57,125,.456,11,39,.282,46,86,.535,.500,17,28,.607,32,63,95,54,23,6,22,33,142
Kelan Martin,SF,25,16,0,70,10,27,.370,5,13,.385,5,14,.357,.463,2,2,1.000,2,11,13,3,4,1,4,6,27
Kenyon Martin Jr.,SF,20,22,0,423,60,112,.536,8,22,.364,52,90,.578,.571,23,32,.719,40,60,100,15,13,20,19,38,151
Frank Mason III,PG,26,4,1,79,9,24,.375,2,5,.400,7,19,.368,.417,5,7,.714,3,9,12,12,0,0,5,7,25
Garrison Mathews,SG,24,42,22,773,76,180,.422,59,146,.404,17,34,.500,.586,60,68,.882,14,52,66,20,24,6,6,78,271
Dakota Mathias,SG,25,8,2,123,19,48,.396,8,26,.308,11,22,.500,.479,2,6,.333,1,6,7,13,1,3,1,7,48
Wesley Matthews,SG,34,42,5,835,62,175,.354,47,138,.341,15,37,.405,.489,18,21,.857,14,53,67,42,24,13,18,59,189
Tyrese Maxey,SG,20,42,6,625,130,287,.453,19,66,.288,111,221,.502,.486,30,35,.857,9,61,70,67,15,7,27,48,309
Skylar Mays,SG,23,22,0,173,25,63,.397,10,27,.370,15,36,.417,.476,17,20,.850,9,14,23,20,8,0,6,11,77
Patrick McCaw,SF,25,5,0,33,1,1,1.000,0,0,,1,1,1.000,1.000,3,3,1.000,1,2,3,4,2,0,0,6,5
CJ McCollum,SG,29,24,24,787,205,459,.447,99,242,.409,106,217,.488,.554,62,73,.849,12,78,90,115,26,13,32,43,571
T.J. McConnell,PG,28,45,2,1149,160,292,.548,7,24,.292,153,268,.571,.560,18,30,.600,34,129,163,293,77,17,82,71,345
Jaden McDaniels,PF,20,43,9,942,108,245,.441,50,131,.382,58,114,.509,.543,19,33,.576,33,119,152,48,20,45,28,105,285
Jalen McDaniels,SF,23,24,1,258,38,85,.447,8,30,.267,30,55,.545,.494,16,23,.696,8,40,48,11,3,5,17,34,100
Doug McDermott,PF,29,46,17,1154,238,457,.521,80,207,.386,158,250,.632,.608,56,67,.836,46,124,170,65,13,4,38,82,612
Sean McDermott,SF,24,13,0,148,13,30,.433,5,19,.263,8,11,.727,.517,8,8,1.000,6,11,17,4,2,2,4,8,39
JaVale McGee,C,33,34,1,509,113,216,.523,5,20,.250,108,196,.551,.535,37,57,.649,55,117,172,33,17,40,46,82,268
Rodney McGruder,SG,29,16,2,194,37,70,.529,11,24,.458,26,46,.565,.607,6,8,.750,8,14,22,16,8,1,7,12,91
Alfonzo McKinnie,SF,28,28,0,148,25,48,.521,8,21,.381,17,27,.630,.604,9,13,.692,10,20,30,2,3,0,2,15,67
Jordan McLaughlin,PG,24,30,2,621,62,169,.367,20,58,.345,42,111,.378,.426,12,16,.750,14,57,71,140,34,6,34,30,156
Ben McLemore,SG,27,32,4,537,80,224,.357,55,166,.331,25,58,.431,.480,23,32,.719,11,55,66,28,20,3,28,51,238
Nicolò Melli,PF,30,26,1,298,23,71,.324,9,41,.220,14,30,.467,.387,7,8,.875,16,54,70,30,10,1,7,34,62
De'Anthony Melton,PG,22,35,1,696,131,273,.480,63,139,.453,68,134,.507,.595,27,35,.771,23,89,112,93,43,17,43,58,352
Sam Merrill,SG,24,21,1,149,20,43,.465,13,28,.464,7,15,.467,.616,2,2,1.000,6,14,20,16,5,1,8,8,55
Chimezie Metu,C,23,18,0,167,34,58,.586,3,7,.429,31,51,.608,.612,7,10,.700,16,31,47,15,3,10,11,25,78
Khris Middleton,SF,29,48,48,1607,360,738,.488,105,243,.432,255,495,.515,.559,146,165,.885,37,251,288,262,54,8,134,118,971
Darius Miller,SF,30,17,0,184,21,45,.467,16,39,.410,5,6,.833,.644,12,12,1.000,2,21,23,18,10,5,8,13,70
Patty Mills,PG,32,46,0,1199,201,466,.431,125,320,.391,76,146,.521,.565,54,59,.915,15,62,77,118,31,1,45,58,581
Paul Millsap,PF,35,39,34,882,136,271,.502,40,105,.381,96,166,.578,.576,52,74,.703,56,131,187,67,36,25,33,80,364
Shake Milton,SG,24,42,2,1022,215,472,.456,45,137,.328,170,335,.507,.503,116,134,.866,25,72,97,127,28,11,72,91,591
Donovan Mitchell,SG,24,46,46,1535,402,914,.440,159,394,.404,243,520,.467,.527,216,255,.847,46,157,203,251,48,13,133,100,1179
Adam Mokoka,SG,22,9,0,47,6,15,.400,1,8,.125,5,7,.714,.433,0,0,,1,3,4,4,2,1,2,5,13
Malik Monk,SG,22,32,0,694,148,322,.460,70,165,.424,78,157,.497,.568,53,65,.815,12,73,85,61,16,4,47,39,419
E'Twaun Moore,SG,31,24,1,348,43,102,.422,8,29,.276,35,73,.479,.461,8,10,.800,13,29,42,35,14,4,18,31,102
Ja Morant,PG,21,39,39,1229,265,599,.442,35,138,.254,230,461,.499,.472,176,233,.755,36,96,132,293,35,7,112,58,741
Juwan Morgan,PF,23,19,0,84,7,17,.412,3,11,.273,4,6,.667,.500,1,5,.200,6,10,16,4,4,0,2,14,18
Marcus Morris,PF,31,39,11,994,178,392,.454,96,204,.471,82,188,.436,.577,47,55,.855,25,127,152,41,19,10,34,78,499
Markieff Morris,PF,31,44,20,855,109,256,.426,50,146,.342,59,110,.536,.523,30,41,.732,33,168,201,47,11,14,33,76,298
Monte Morris,PG,25,37,10,998,148,314,.471,41,117,.350,107,197,.543,.537,49,64,.766,8,73,81,123,27,10,25,37,386
Mychal Mulder,PG,26,41,2,412,50,123,.407,41,107,.383,9,16,.563,.573,10,17,.588,1,34,35,16,8,8,9,28,151
Dejounte Murray,PG,24,46,46,1461,302,660,.458,41,133,.308,261,527,.495,.489,77,95,.811,35,285,320,240,70,5,80,96,722
Jamal Murray,PG,23,47,47,1671,373,777,.480,128,311,.412,245,466,.526,.562,127,147,.864,36,154,190,227,61,12,104,93,1001
Mike Muscala,C,29,35,0,645,119,267,.446,68,184,.370,51,83,.614,.573,33,36,.917,19,113,132,28,8,11,21,54,339
Sviatoslav Mykhailiuk,SF-SG,23,45,9,837,118,300,.393,71,213,.333,47,87,.540,.512,27,35,.771,16,87,103,68,35,8,56,36,334
Abdel Nader,SF,27,24,0,355,57,116,.491,18,43,.419,39,73,.534,.569,28,37,.757,7,55,62,19,10,9,19,34,160
Larry Nance Jr.,PF,28,29,27,950,115,236,.487,36,95,.379,79,141,.560,.564,26,41,.634,50,155,205,91,52,17,44,61,292
Aaron Nesmith,SF,21,28,0,395,33,91,.363,21,66,.318,12,25,.480,.478,11,16,.688,14,51,65,10,9,6,15,43,98
Raul Neto,PG,28,42,6,873,135,299,.452,40,110,.364,95,189,.503,.518,36,45,.800,17,82,99,92,47,4,31,66,346
Georges Niang,PF,27,49,0,672,96,225,.427,64,162,.395,32,63,.508,.569,5,5,1.000,15,90,105,35,14,6,31,73,261
Zeke Nnaji,PF,20,31,1,325,43,82,.524,19,46,.413,24,36,.667,.640,12,15,.800,13,39,52,5,4,3,7,23,117
Nerlens Noel,C,26,44,21,1001,92,153,.601,0,2,.000,92,151,.609,.601,25,38,.658,99,170,269,28,46,90,53,115,209
Jaylen Nowell,SG,21,36,0,687,135,304,.444,47,132,.356,88,172,.512,.521,41,49,.837,18,66,84,59,21,10,27,67,358
Frank Ntilikina,PG,22,18,4,253,23,64,.359,17,37,.459,6,27,.222,.492,7,14,.500,4,20,24,14,15,1,10,33,70
Kendrick Nunn,PG,25,38,26,1087,198,433,.457,77,207,.372,121,226,.535,.546,39,43,.907,16,103,119,100,39,9,58,69,512
Jusuf Nurkić,C,26,17,17,378,64,132,.485,6,18,.333,58,114,.509,.508,26,43,.605,33,95,128,48,16,13,34,48,160
David Nwaba,SF,28,30,9,679,106,218,.486,17,63,.270,89,155,.574,.525,47,68,.691,40,78,118,31,30,21,17,60,276
Jordan Nwora,SF,22,18,1,152,27,67,.403,14,30,.467,13,37,.351,.507,13,17,.765,3,28,31,4,10,3,15,12,81
Royce O'Neale,SF,27,49,49,1554,121,269,.450,79,196,.403,42,73,.575,.597,31,36,.861,59,266,325,122,38,23,57,134,352
Semi Ojeleye,PF,26,40,9,765,71,174,.408,49,125,.392,22,49,.449,.549,22,30,.733,25,92,117,30,11,0,16,44,213
Jahlil Okafor,C,25,12,0,120,25,42,.595,0,3,.000,25,39,.641,.595,1,2,.500,13,14,27,3,2,2,4,10,51
Chuma Okeke,PF,22,34,8,808,88,205,.429,36,94,.383,52,111,.468,.517,21,27,.778,33,103,136,72,30,15,27,36,233
Josh Okogie,SG,22,38,22,757,56,162,.346,16,69,.232,40,93,.430,.395,51,63,.810,34,62,96,43,34,16,28,80,179
Onyeka Okongwu,C,20,28,1,268,38,61,.623,0,1,.000,38,60,.633,.623,18,30,.600,23,53,76,6,11,15,13,44,94
Isaac Okoro,SG,20,44,44,1409,130,310,.419,36,122,.295,94,188,.500,.477,56,82,.683,37,86,123,76,46,20,65,122,352
KZ Okpala,PF,21,25,9,322,27,66,.409,11,37,.297,16,29,.552,.492,2,6,.333,15,35,50,11,6,8,12,44,67
Victor Oladipo,SG,28,31,31,1022,224,554,.404,75,232,.323,149,322,.463,.472,95,127,.748,10,140,150,147,43,13,76,78,618
Kelly Olynyk,C-PF,29,48,40,1295,194,431,.450,88,272,.324,106,159,.667,.552,47,56,.839,45,243,288,108,44,31,60,135,523
Miye Oni,SG,23,35,0,302,24,64,.375,21,56,.375,3,8,.375,.539,5,6,.833,16,43,59,10,5,7,11,40,74
Cedi Osman,SF,25,46,17,1131,158,449,.352,78,256,.305,80,193,.415,.439,53,71,.746,28,126,154,119,43,7,47,84,447
Daniel Oturu,C,21,18,0,77,12,23,.522,0,1,.000,12,22,.545,.522,2,4,.500,8,13,21,6,1,3,5,12,26
Kelly Oubre Jr.,SF,25,48,48,1468,275,631,.436,74,243,.305,201,388,.518,.494,98,142,.690,71,219,290,66,50,38,58,109,722
Jabari Parker,PF,25,3,0,27,4,7,.571,0,1,.000,4,6,.667,.571,0,0,,1,5,6,1,0,1,3,4,8
Eric Paschall,PF,24,39,2,676,144,293,.491,17,53,.321,127,240,.529,.520,64,89,.719,27,97,124,51,12,7,41,65,369
Anžejs Pasečņiks,C,25,1,0,6,0,1,.000,0,1,.000,0,0,,.000,0,0,,1,0,1,1,0,0,5,2,0
Patrick Patterson,PF,31,22,2,295,38,82,.463,22,57,.386,16,25,.640,.598,8,10,.800,7,29,36,12,10,6,8,30,106
Justin Patton,C,23,13,6,247,29,70,.414,9,34,.265,20,36,.556,.479,3,4,.750,14,35,49,14,12,14,4,34,70
Chris Paul,PG,35,47,47,1490,285,582,.490,61,168,.363,224,414,.541,.542,119,128,.930,19,200,219,410,66,11,108,115,750
Cameron Payne,PG,26,37,0,634,96,204,.471,36,91,.396,60,113,.531,.559,26,29,.897,8,78,86,138,21,9,38,65,254
Elfrid Payton,PG,26,41,41,1098,203,465,.437,19,77,.247,184,388,.474,.457,66,93,.710,53,104,157,147,32,9,73,77,491
Norvel Pelle,C,27,5,0,35,3,8,.375,0,0,,3,8,.375,.375,4,6,.667,4,7,11,1,0,5,3,10,10
Reggie Perry,PF,20,17,0,180,27,64,.422,4,18,.222,23,46,.500,.453,8,11,.727,20,40,60,14,4,6,13,31,66
Theo Pinson,SG,25,14,0,31,1,9,.111,0,8,.000,1,1,1.000,.111,0,0,,0,2,2,1,0,0,1,4,2
Mason Plumlee,C,30,47,47,1289,196,324,.605,0,7,.000,196,317,.618,.605,100,151,.662,126,314,440,167,40,43,92,163,492
Jakob Poeltl,C,25,47,29,1201,172,275,.625,0,0,,172,275,.625,.625,34,85,.400,151,230,381,84,29,78,59,105,378
Vincent Poirier,C,27,10,0,39,3,12,.250,0,1,.000,3,11,.273,.250,2,6,.333,6,8,14,2,0,3,4,8,8
Aleksej Pokusevski,PF,19,29,12,675,73,232,.315,32,123,.260,41,109,.376,.384,19,23,.826,21,114,135,57,14,29,50,30,197
Jordan Poole,SG,21,29,6,505,107,242,.442,50,138,.362,57,104,.548,.545,48,53,.906,5,40,45,48,11,3,24,42,312
Jontay Porter,PF,21,4,0,15,2,6,.333,1,4,.250,1,2,.500,.417,0,0,,2,6,8,1,2,0,4,3,5
Kevin Porter Jr.,SG,20,12,9,364,74,172,.430,16,69,.232,58,103,.563,.477,19,32,.594,4,34,38,71,12,6,40,23,183
Michael Porter Jr.,SF,22,39,32,1171,248,462,.537,96,214,.449,152,248,.613,.641,60,80,.750,70,224,294,39,25,37,43,83,652
Otto Porter,SF-PF,27,28,6,606,98,227,.432,39,104,.375,59,123,.480,.518,36,42,.857,28,124,152,55,16,4,25,41,271
Bobby Portis,C,25,45,2,940,210,389,.540,49,104,.471,161,285,.565,.603,30,40,.750,77,229,306,48,34,17,35,79,499
Kristaps Porziņģis,C,25,31,31,949,236,498,.474,70,195,.359,166,303,.548,.544,83,101,.822,56,219,275,49,14,50,42,83,625
Dwight Powell,C,29,34,8,504,49,103,.476,5,18,.278,44,85,.518,.500,53,68,.779,39,76,115,28,17,12,18,81,156
Norman Powell,SG-SF,27,47,36,1429,308,623,.494,129,293,.440,179,330,.542,.598,154,182,.846,25,116,141,83,59,11,85,111,899
Taurean Prince,PF,26,32,10,692,90,239,.377,43,113,.381,47,126,.373,.467,49,57,.860,16,97,113,56,19,19,34,58,272
Payton Pritchard,SG,23,44,1,856,116,258,.450,59,144,.410,57,114,.500,.564,21,24,.875,23,74,97,85,25,7,38,82,312
Immanuel Quickley,PG,21,45,3,895,173,449,.385,85,230,.370,88,219,.402,.480,125,140,.893,20,87,107,102,23,10,44,88,556
Jahmi'us Ramsey,SG,19,5,0,17,3,5,.600,1,3,.333,2,2,1.000,.700,0,0,,0,4,4,1,0,1,1,0,7
Chasson Randle,PG,27,21,5,465,42,109,.385,24,64,.375,18,45,.400,.495,15,18,.833,3,40,43,47,10,2,25,39,123
Julius Randle,PF,26,49,49,1810,403,864,.466,101,243,.416,302,621,.486,.525,221,279,.792,67,457,524,286,42,11,164,153,1128
Cam Reddish,SF,21,26,21,750,96,263,.365,33,126,.262,63,137,.460,.428,67,82,.817,22,82,104,35,33,9,34,68,292
J.J. Redick,SG,36,31,0,576,87,214,.407,51,140,.364,36,74,.486,.526,45,47,.957,3,49,52,40,9,2,25,37,270
Paul Reed,PF,21,12,0,100,20,42,.476,0,6,.000,20,36,.556,.476,0,2,.000,12,15,27,5,5,6,7,15,40
Naz Reid,C,21,48,13,918,201,387,.519,39,112,.348,162,275,.589,.570,84,117,.718,54,159,213,54,27,53,50,127,525
Cameron Reynolds,SF,25,3,0,6,1,2,.500,0,0,,1,2,.500,.500,0,0,,0,0,0,0,0,0,0,0,2
Nick Richards,PF,23,13,0,51,4,7,.571,0,0,,4,7,.571,.571,7,11,.636,2,7,9,1,0,0,3,5,15
Josh Richardson,SG,27,38,38,1218,172,396,.434,59,184,.321,113,212,.533,.509,75,81,.926,32,103,135,106,35,15,59,97,478
Grant Riller,PG,23,1,0,5,0,2,.000,0,1,.000,0,1,.000,.000,0,0,,0,0,0,0,0,0,0,0,0
Austin Rivers,SG,28,21,2,442,58,135,.430,28,77,.364,30,58,.517,.533,10,14,.714,5,42,47,42,12,0,22,32,154
Andre Roberson,SG,29,5,0,63,2,14,.143,1,8,.125,1,6,.167,.179,1,2,.500,7,8,15,4,3,1,2,4,6
Duncan Robinson,SF,26,50,50,1637,218,500,.436,173,429,.403,45,71,.634,.609,47,56,.839,4,187,191,89,27,11,60,126,656
Glenn Robinson III,SF,27,23,2,369,42,99,.424,16,44,.364,26,55,.473,.505,21,23,.913,11,34,45,20,4,3,11,23,121
Jerome Robinson,SG,23,17,6,305,28,95,.295,11,42,.262,17,53,.321,.353,16,20,.800,4,34,38,25,12,6,19,31,83
Mitchell Robinson,C,22,31,29,853,115,176,.653,0,0,,115,176,.653,.653,26,53,.491,113,139,252,17,35,45,26,86,256
Isaiah Roby,PF,22,43,23,1008,147,293,.502,22,70,.314,125,223,.561,.539,66,93,.710,67,177,244,76,36,29,78,113,382
Rajon Rondo,PG,34,28,2,415,45,113,.398,17,45,.378,28,68,.412,.473,1,2,.500,4,52,56,98,21,2,43,29,108
Derrick Rose,PG,32,29,3,690,142,337,.421,27,76,.355,115,261,.441,.461,65,78,.833,10,55,65,121,33,12,50,31,376
Terrence Ross,SG,29,40,2,1182,225,557,.404,85,246,.346,140,311,.450,.480,105,118,.890,13,124,137,94,44,19,66,80,640
Terry Rozier,SG,26,47,47,1570,340,729,.466,155,380,.408,185,349,.530,.573,123,147,.837,26,167,193,162,59,17,89,82,958
Ricky Rubio,PG,30,46,31,1215,126,327,.385,37,127,.291,89,200,.445,.442,95,112,.848,20,127,147,316,63,2,88,102,384
D'Angelo Russell,PG,24,20,19,583,139,326,.426,59,148,.399,80,178,.449,.517,48,64,.750,9,43,52,101,22,10,54,39,385
Domantas Sabonis,PF,24,47,47,1688,353,671,.526,36,118,.305,317,553,.573,.553,195,271,.720,120,412,532,283,55,26,159,159,937
Luka Šamanić,PF,21,19,1,168,25,52,.481,8,27,.296,17,25,.680,.558,9,17,.529,10,31,41,5,4,3,11,18,67
JaKarr Sampson,PF,27,18,0,120,17,39,.436,2,7,.286,15,32,.469,.462,10,14,.714,11,25,36,1,2,4,7,13,46
Dario Šarić,C,26,30,0,557,112,236,.475,35,96,.365,77,140,.550,.549,52,58,.897,30,96,126,40,16,3,39,63,311
Tomáš Satoranský,SG,29,37,12,855,113,216,.523,32,77,.416,81,139,.583,.597,47,51,.922,21,75,96,185,29,9,63,58,305
Dennis Schröder,SG,27,46,46,1461,242,561,.431,48,147,.327,194,414,.469,.474,171,205,.834,23,139,162,234,56,11,127,125,703
Mike Scott,PF,32,31,8,551,44,126,.349,33,99,.333,11,27,.407,.480,6,10,.600,8,80,88,20,18,5,16,43,127
Collin Sexton,SG,22,42,42,1508,371,773,.480,68,187,.364,303,586,.517,.524,197,242,.814,32,88,120,174,51,4,117,115,1007
Landry Shamet,SG,23,41,1,828,109,273,.399,79,203,.389,30,70,.429,.544,38,45,.844,9,64,73,46,19,5,30,53,335
Iman Shumpert,SG,30,2,0,11,1,4,.250,0,3,.000,1,1,1.000,.250,0,0,,1,0,1,0,1,0,1,0,2
Pascal Siakam,PF,26,40,40,1408,292,649,.450,52,172,.302,240,477,.503,.490,179,215,.833,72,222,294,188,44,25,81,128,815
Chris Silva,PF,24,13,0,87,10,15,.667,1,1,1.000,9,14,.643,.700,11,15,.733,7,19,26,6,1,5,10,21,32
Ben Simmons,PG,24,42,42,1403,247,453,.545,3,9,.333,244,444,.550,.549,143,224,.638,74,258,332,304,63,27,146,132,640
Anfernee Simons,SG,21,42,0,709,115,282,.408,84,201,.418,31,81,.383,.557,29,36,.806,8,89,97,62,8,5,33,72,343
Deividas Sirvydis,SG,20,11,0,22,3,10,.300,3,9,.333,0,1,.000,.450,1,2,.500,0,4,4,1,1,0,1,1,10
Alen Smailagić,PF,20,5,1,26,4,10,.400,2,5,.400,2,5,.400,.500,1,4,.250,2,1,3,0,0,1,0,5,11
Marcus Smart,PG,26,31,28,987,130,322,.404,59,175,.337,71,147,.483,.495,80,102,.784,17,76,93,170,47,16,51,76,399
Dennis Smith Jr.,PG,23,20,7,361,53,132,.402,18,53,.340,35,79,.443,.470,12,18,.667,11,42,53,68,21,14,24,31,136
Ish Smith,PG,32,20,1,413,45,122,.369,6,21,.286,39,101,.386,.393,8,17,.471,10,58,68,92,15,4,20,22,104
Jalen Smith,PF,20,16,0,73,9,25,.360,2,10,.200,7,15,.467,.400,1,3,.333,5,11,16,2,0,2,4,9,21
Tony Snell,SG,29,37,18,783,73,139,.525,54,94,.574,19,45,.422,.719,7,7,1.000,13,72,85,49,6,9,17,57,207
Ray Spalding,C,23,2,0,19,2,4,.500,0,1,.000,2,3,.667,.500,0,2,.000,2,2,4,0,0,2,3,3,4
Cassius Stanley,SG,21,13,0,35,4,16,.250,1,5,.200,3,11,.273,.281,4,5,.800,4,5,9,0,0,2,1,8,13
Lamar Stevens,PF,23,33,0,441,56,126,.444,4,24,.167,52,102,.510,.460,31,44,.705,21,67,88,24,16,12,19,44,147
Isaiah Stewart,C,19,47,2,902,128,231,.554,10,24,.417,118,207,.570,.576,31,46,.674,102,169,271,37,24,47,43,118,297
Max Strus,SF,24,25,0,333,57,122,.467,35,98,.357,22,24,.917,.611,11,16,.688,3,22,25,13,5,0,4,29,160
Edmond Sumner,SG,25,35,7,462,76,151,.503,20,53,.377,56,98,.571,.570,35,43,.814,13,47,60,24,17,4,30,48,207
Jae'Sean Tate,SF,25,49,37,1398,209,401,.521,40,123,.325,169,278,.608,.571,67,92,.728,96,167,263,95,54,29,54,155,525
Jayson Tatum,SF,22,44,44,1559,407,899,.453,124,327,.379,283,572,.495,.522,171,198,.864,32,274,306,187,57,20,106,84,1109
Jeff Teague,PG,32,36,5,647,80,193,.415,26,58,.448,54,135,.400,.482,51,61,.836,10,49,59,80,26,9,40,43,237
Garrett Temple,SG,34,37,12,1002,112,264,.424,46,137,.336,66,127,.520,.511,31,38,.816,21,92,113,73,33,18,36,85,301
Tyrell Terry,PG,20,11,0,56,5,16,.313,0,7,.000,5,9,.556,.313,1,3,.333,0,6,6,6,5,0,2,2,11
Daniel Theis,C,28,46,37,1113,169,309,.547,35,103,.340,134,206,.650,.604,49,74,.662,57,178,235,75,26,48,44,124,422
Brodric Thomas,SG,24,13,1,145,13,44,.295,5,24,.208,8,20,.400,.352,17,21,.810,2,14,16,12,7,5,8,16,48
Matt Thomas,SG,26,29,0,222,29,76,.382,19,51,.373,10,25,.400,.507,6,7,.857,4,23,27,14,3,0,10,13,83
Tristan Thompson,PF,29,36,31,811,119,223,.534,0,3,.000,119,220,.541,.534,48,80,.600,113,189,302,36,13,13,35,75,286
Sindarius Thornwell,SG,26,14,1,73,7,21,.333,3,9,.333,4,12,.333,.405,0,2,.000,1,4,5,4,5,1,4,3,17
Matisse Thybulle,SG,23,47,5,901,67,167,.401,31,102,.304,36,65,.554,.494,8,14,.571,23,63,86,46,70,46,19,94,173
Killian Tillie,C,22,8,0,58,5,21,.238,2,11,.182,3,10,.300,.286,2,3,.667,3,3,6,1,2,4,1,8,14
Xavier Tillman Sr.,PF,22,37,7,690,97,188,.516,11,42,.262,86,146,.589,.545,25,35,.714,45,107,152,50,30,21,27,82,230
Obi Toppin,PF,22,40,0,471,70,146,.479,17,57,.298,53,89,.596,.538,13,18,.722,17,70,87,21,11,11,20,42,170
Juan Toscano-Anderson,SG,27,35,15,609,64,115,.557,21,48,.438,43,67,.642,.648,13,18,.722,18,111,129,73,21,15,34,69,162
Axel Toupane,SF,28,5,1,41,2,7,.286,0,1,.000,2,6,.333,.286,0,0,,0,4,4,2,0,3,0,3,4
Karl-Anthony Towns,C,25,30,30,1030,260,532,.489,71,185,.384,189,347,.545,.555,147,168,.875,82,248,330,129,23,46,95,107,738
Gary Trent Jr.,SG,22,46,28,1425,249,596,.418,137,342,.401,112,254,.441,.533,62,81,.765,22,87,109,64,43,8,32,73,697
P.J. Tucker,PF,35,35,32,1003,49,135,.363,28,90,.311,21,45,.467,.467,18,23,.783,36,118,154,46,29,20,33,93,144
Rayjon Tucker,PG,23,5,0,23,1,4,.250,1,2,.500,0,2,.000,.375,8,8,1.000,1,3,4,1,0,0,0,3,11
Myles Turner,C,24,45,45,1402,201,418,.481,66,198,.333,135,220,.614,.560,105,134,.784,59,232,291,46,40,156,66,161,573
Jonas Valančiūnas,C,28,42,41,1156,279,502,.556,12,39,.308,267,463,.577,.568,109,143,.762,174,352,526,73,24,27,75,126,679
Denzel Valentine,SG,27,43,3,787,122,321,.380,62,186,.333,60,135,.444,.477,11,11,1.000,19,143,162,74,26,1,26,48,317
Jarred Vanderbilt,PF,21,46,25,792,98,163,.601,1,4,.250,97,159,.610,.604,43,74,.581,70,169,239,58,43,30,44,89,240
Fred VanVleet,SG,26,44,44,1601,285,725,.393,147,396,.371,138,329,.419,.494,154,174,.885,28,158,186,270,76,34,86,105,871
Devin Vassell,SF,20,40,1,679,72,178,.404,37,92,.402,35,86,.407,.508,27,31,.871,17,102,119,37,36,12,17,57,208
Gabe Vincent,PG,24,35,6,508,69,186,.371,33,118,.280,36,68,.529,.460,20,23,.870,7,32,39,51,17,2,27,58,191
Noah Vonleh,PF,25,4,0,11,0,3,.000,0,2,.000,0,1,.000,.000,0,0,,0,1,1,1,0,0,2,2,0
Nikola Vučević,C,30,49,49,1654,477,986,.484,123,309,.398,354,677,.523,.546,107,128,.836,95,471,566,185,46,33,86,91,1184
Dean Wade,PF,24,41,8,626,70,167,.419,40,112,.357,30,55,.545,.539,16,21,.762,20,93,113,40,14,14,15,45,196
Moritz Wagner,C,23,31,14,424,66,135,.489,15,48,.313,51,87,.586,.544,42,54,.778,16,72,88,36,22,8,27,70,189
Kemba Walker,PG,30,31,31,954,189,476,.397,87,249,.349,102,227,.449,.488,89,95,.937,9,102,111,149,35,9,65,41,554
Lonnie Walker,SG,22,37,30,968,164,386,.425,63,177,.356,101,209,.483,.506,36,46,.783,9,94,103,61,19,13,38,73,427
John Wall,PG,30,32,32,1018,229,573,.400,62,195,.318,167,378,.442,.454,126,169,.746,15,93,108,217,33,25,108,39,646
Brad Wanamaker,PG,31,43,0,691,72,193,.373,14,65,.215,58,128,.453,.409,56,63,.889,10,61,71,109,28,6,43,63,214
T.J. Warren,SF,27,4,4,117,27,51,.529,0,7,.000,27,44,.614,.529,8,10,.800,2,12,14,5,2,0,4,16,62
P.J. Washington,PF,22,45,45,1327,187,434,.431,60,160,.375,127,274,.464,.500,84,108,.778,65,226,291,121,44,57,101,124,518
Yuta Watanabe,SF,26,30,1,337,26,76,.342,13,37,.351,13,39,.333,.428,9,11,.818,26,68,94,14,11,14,9,29,74
Tremont Waters,PG,23,14,1,110,12,36,.333,6,17,.353,6,19,.316,.417,7,8,.875,3,6,9,34,8,0,13,6,37
Paul Watson,SF,26,24,0,234,25,55,.455,20,44,.455,5,11,.455,.636,2,4,.500,3,32,35,11,5,2,6,31,72
Quinndary Weatherspoon,SG,24,12,0,50,2,10,.200,0,2,.000,2,8,.250,.200,2,2,1.000,0,3,3,4,4,1,8,9,6
Russell Westbrook,PG,32,41,41,1439,338,779,.434,55,175,.314,283,604,.469,.469,161,265,.608,66,359,425,431,52,17,206,117,892
Coby White,PG,20,45,36,1411,245,600,.408,99,285,.347,146,315,.463,.491,77,86,.895,21,181,202,207,23,8,100,113,666
Derrick White,SG,26,23,19,668,109,275,.396,52,152,.342,57,123,.463,.491,58,69,.841,5,57,62,75,16,24,33,62,328
Hassan Whiteside,C,31,28,1,416,96,173,.555,0,1,.000,96,172,.558,.555,33,63,.524,49,120,169,16,6,39,32,52,225
Greg Whittington,PF,27,4,0,12,0,3,.000,0,2,.000,0,1,.000,.000,0,0,,0,0,0,0,0,0,0,0,0
Andrew Wiggins,PF,25,50,50,1617,339,714,.475,104,260,.400,235,454,.518,.548,126,180,.700,50,190,240,113,46,47,96,109,908
Grant Williams,PF,22,42,8,771,72,161,.447,34,86,.395,38,75,.507,.553,19,36,.528,38,87,125,44,23,16,34,110,197
Kenrich Williams,PF,26,49,7,988,155,272,.570,35,78,.449,120,194,.619,.634,23,40,.575,60,140,200,94,33,12,47,93,368
Lou Williams,PG,34,45,3,997,197,470,.419,48,124,.387,149,346,.431,.470,109,127,.858,17,80,97,159,41,5,70,45,551
Patrick Williams,PF,19,47,47,1340,180,375,.480,39,102,.382,141,273,.516,.532,61,81,.753,43,182,225,62,34,33,66,98,460
Robert Williams,C,23,42,5,773,151,207,.729,0,1,.000,151,206,.733,.729,42,64,.656,108,178,286,72,38,77,40,84,344
Zion Williamson,PF,20,44,44,1444,444,712,.624,8,23,.348,436,689,.633,.629,264,373,.708,115,196,311,155,41,30,113,101,1160
D.J. Wilson,PF,24,21,0,210,35,80,.438,19,46,.413,16,34,.471,.556,7,10,.700,9,44,53,8,2,9,12,28,96
Dylan Windler,SF,24,31,0,513,57,130,.438,26,77,.338,31,53,.585,.538,21,27,.778,20,87,107,33,19,12,32,37,161
Justise Winslow,SF,24,16,0,337,50,146,.342,5,41,.122,45,105,.429,.360,9,16,.563,13,64,77,28,12,7,25,32,114
Cassius Winston,PG,22,13,0,77,9,22,.409,7,13,.538,2,9,.222,.568,4,4,1.000,0,7,7,10,2,1,1,7,29
James Wiseman,C,19,36,24,781,173,339,.510,12,36,.333,161,303,.531,.528,53,83,.639,51,158,209,23,10,35,59,117,411
Christian Wood,C,25,26,26,815,210,393,.534,42,116,.362,168,277,.606,.588,80,123,.650,45,210,255,39,24,35,48,52,542
Robert Woodard,SF,21,11,0,29,7,14,.500,1,4,.250,6,10,.600,.536,3,8,.375,3,8,11,0,0,2,1,2,18
Delon Wright,SG-PG,28,41,31,1159,150,324,.463,36,100,.360,114,224,.509,.519,83,103,.806,39,141,180,194,62,19,50,48,419
Thaddeus Young,PF,32,44,11,1103,250,425,.588,6,25,.240,244,400,.610,.595,43,70,.614,109,174,283,191,56,26,88,110,549
Trae Young,PG,22,47,47,1611,357,828,.431,110,307,.358,247,521,.474,.498,361,414,.872,32,152,184,443,41,11,205,93,1185
Cody Zeller,C,28,30,20,644,111,209,.531,3,22,.136,108,187,.578,.538,48,69,.696,77,131,208,61,22,11,27,70,273
Ivica Zubac,C,23,51,12,1105,171,268,.638,0,3,.000,171,265,.645,.638,97,117,.829,140,233,373,56,21,48,55,132,439
